year,month,country,female,male,total
2015,Agosto,Montserrat/Territorio Británico de Ultramar,0,1,1
2015,Septiembre,Nicaragua,120,155,275
2015,Julio,Singapur,13,38,51
2015,Agosto,Islas Turcas y Caicos/Territorio Británico de Ultramar,0,1,1
2015,Agosto,Bélgica,275,471,746
2015,Agosto,Dinamarca,77,145,222
2015,Septiembre,Kazajistán,4,2,6
2015,Septiembre,Bosnia y Herzegovina,0,3,3
2015,Agosto,Kuwait,1,6,7
2015,Julio,República de Armenia,1,2,3
2015,Agosto,Zambia,0,1,1
2015,Septiembre,Pakistán,4,14,18
2015,Agosto,República CentroÁfricana,5,0,5
2015,Septiembre,Kiribati,0,5,5
2015,Agosto,Singapur,17,28,45
2015,Agosto,Ghana,2,14,16
2015,Julio,Kazajistán,12,2,14
2015,Julio,República Dominicana,494,809,1303
2015,Septiembre,Azerbaiyán,1,8,9
2015,Agosto,Guyana,12,17,29
2015,Septiembre,Sudán,0,4,4
2015,Septiembre,Uganda,2,8,10
2015,Agosto,Perú,5665,7176,12841
2015,Julio,Iraq,1,8,9
2015,Agosto,República Democrática del Congo,1,2,3
2015,Agosto,Eslovaquia,18,20,38
2015,Agosto,Luxemburgo,13,17,30
2015,Septiembre,El Salvador,814,1056,1870
2015,Julio,España,3518,7030,10548
2015,Julio,Islas Fiji,0,1,1
2015,Julio,Federación de Rusia,173,213,386
2015,Agosto,Antigua y Barbuda,1,10,11
2015,Septiembre,Hungría,27,56,83
2015,Julio,Jordania,3,2,5
2015,Julio,Rumania,65,86,151
2015,Julio,Lituania,24,18,42
2015,Julio,Madagascar,1,0,1
2015,Agosto,Letonia,11,10,21
2015,Agosto,Jamaica,28,43,71
2015,Septiembre,México,4627,8692,13319
2015,Septiembre,Argelia,2,9,11
2015,Septiembre,Santa Lucia,4,8,12
2015,Julio,Chile,4313,5159,9472
2015,Septiembre,Nepal,3,7,10
2015,Septiembre,Jamaica,22,63,85
2015,Septiembre,China,340,855,1195
2015,Julio,Croacia,7,52,59
2015,Agosto,Liechtenstein,0,3,3
2015,Septiembre,Níger,0,2,2
2015,Agosto,Lituania,21,24,45
2015,Septiembre,Georgia,2,10,12
2015,Julio,Sudán,2,10,12
2015,Septiembre,Bolivia,573,718,1291
2015,Agosto,Irán,4,20,24
2015,Julio,Arabia Saudita,2,18,20
2015,Agosto,República Dominicana,705,941,1646
2015,Julio,Azerbaiyán,2,6,8
2015,Julio,República de Irlanda,196,285,481
2015,Septiembre,Luxemburgo,9,8,17
2015,Septiembre,India,90,585,675
2015,Agosto,Ecuador,7444,9358,16802
2015,Agosto,Nigeria,13,13,26
2015,Septiembre,Mónaco,1,1,2
2015,Agosto,México,5265,9645,14910
2015,Septiembre,Zambia,6,8,14
2015,Agosto,Botsuana,1,1,2
2015,Agosto,Paraguay,275,234,509
2015,Septiembre,Myanmar,0,1,1
2015,Septiembre,Burundi,0,1,1
2015,Septiembre,Islas Caimán/Territorio Británico de Ultramar,0,3,3
2015,Agosto,Bulgaria,21,23,44
2015,Agosto,Zimbabue,0,6,6
2015,Julio,Comoras,0,1,1
2015,Julio,Rwanda,2,1,3
2015,Septiembre,Chile,4077,5182,9259
2015,Agosto,Francia,2166,3409,5575
2015,Julio,Mauricio,2,6,8
2015,Septiembre,Samoa Occidental,1,0,1
2015,Julio,Sudáfrica,78,121,199
2015,Agosto,República de Belarús,7,4,11
2015,Septiembre,Serbia,3,9,12
2015,Julio,San  Vicente y las Granadinas,4,2,6
2015,Septiembre,República de Moldavia,0,1,1
2015,Julio,República de Tayikistán,1,1,2
2015,Julio,República Checa,47,92,139
2015,Julio,Taiwán,78,84,162
2015,Agosto,Ucrania,22,39,61
2015,Septiembre,Andorra,2,10,12
2015,Agosto,Costa Rica,958,1436,2394
2015,Septiembre,Mozambique,3,8,11
2015,Agosto,Líbano,26,41,67
2015,Septiembre,Belice,5,15,20
2015,Septiembre,Polonia,133,228,361
2015,Julio,Albania,2,6,8
2015,Septiembre,Guinea,0,2,2
2015,Julio,Mónaco,0,1,1
2015,Septiembre,Eslovenia,24,23,47
2015,Agosto,Argentina,4203,5839,10042
2015,Julio,El Salvador,815,1026,1841
2015,Julio,Bélgica,497,683,1180
2015,Septiembre,Alemania,1614,2517,4131
2015,Julio,Suecia,244,359,603
2015,Julio,Papúa Nueva Guinea,0,1,1
2015,Agosto,República de Moldavia,4,1,5
2015,Julio,Camerún,2,3,5
2015,Agosto,Guinea,0,1,1
2015,Agosto,Madagascar,1,0,1
2015,Julio,Macedonia,4,5,9
2015,Septiembre,Barbados,3,12,15
2015,Septiembre,San  Vicente y las Granadinas,0,4,4
2015,Julio,Somalia,0,1,1
2015,Agosto,Benín,0,2,2
2015,Julio,Egipto,17,37,54
2015,Septiembre,Lituania,25,17,42
2015,Julio,Brasil,5189,6238,11427
2015,Agosto,Papúa Nueva Guinea,1,2,3
2015,Julio,Noruega,218,258,476
2015,Septiembre,Venezuela,12982,14115,27097
2015,Julio,Hungría,43,63,106
2015,Agosto,Uruguay,387,635,1022
2015,Agosto,Guinea Ecuatorial,0,1,1
2015,Agosto,Santa Sede/Ciudad del Vaticano,0,2,2
2015,Septiembre,Qatar,1,8,9
2015,Julio,Kiribati,0,1,1
2015,Agosto,India,90,584,674
2015,Agosto,Pakistán,7,24,31
2015,Julio,Surinam,21,26,47
2015,Agosto,Chipre,6,10,16
2015,Julio,Granada,2,6,8
2015,Julio,Kirguistán,2,0,2
2015,Julio,Bolivia,661,711,1372
2015,Septiembre,Santa Sede/Ciudad del Vaticano,0,1,1
2015,Agosto,Marruecos,4,13,17
2015,Septiembre,Marruecos,12,20,32
2015,Julio,Afganistán,0,1,1
2015,Agosto,Qatar,0,3,3
2015,Agosto,Aruba,2,0,2
2015,Septiembre,Bélgica,171,376,547
2015,Julio,Micronesia,0,1,1
2015,Septiembre,República de Corea,191,495,686
2015,Agosto,Panamá,2333,2974,5307
2015,Julio,Islas Caimán/Territorio Británico de Ultramar,9,9,18
2015,Septiembre,Nueva Zelanda,65,120,185
2015,Julio,Mozambique,0,2,2
2015,Julio,Islandia,6,6,12
2015,Septiembre,Túnez,7,11,18
2015,Agosto,Estados Unidos de América,15113,25198,40311
2015,Agosto,Vietnam,9,9,18
2015,Julio,Ucrania,41,57,98
2015,Julio,Camboya,1,0,1
2015,Julio,Jamaica,54,74,128
2015,Julio,Liechtenstein,6,1,7
2015,Septiembre,Perú,5043,6217,11260
2015,Julio,Reino Unido de Gran Bretaña e Irlanda del Norte,1619,2808,4427
2015,Septiembre,Estonia,7,7,14
2015,Julio,Libia,0,1,1
2015,Julio,Mongolia,0,1,1
2015,Agosto,Dominica,0,9,9
2015,Agosto,Belice,10,27,37
2015,Agosto,República Árabe Siria,1,2,3
2015,Agosto,Túnez,2,5,7
2015,Julio,Lesoto,1,2,3
2015,Septiembre,Paraguay,313,363,676
2015,Septiembre,Maldivas,0,3,3
2015,Agosto,Suiza,488,702,1190
2015,Julio,Sierra Leona,0,1,1
2015,Septiembre,Kenia,15,24,39
2015,Septiembre,Croacia,19,45,64
2015,Julio,Puerto Rico/Territorio de Estados Unidos,1,1,2
2015,Julio,Letonia,20,23,43
2015,Septiembre,Antigua y Barbuda,1,12,13
2015,Agosto,Afganistán,0,1,1
2015,Julio,San Cristóbal y Nevis,6,9,15
2015,Julio,Ecuador,5835,7671,13506
2015,Julio,Antigua y Barbuda,3,16,19
2015,Septiembre,Portugal,283,628,911
2015,Septiembre,Irán,5,18,23
2015,Septiembre,Federación de Rusia,190,291,481
2015,Septiembre,Turquía,40,144,184
2015,Julio,Zimbabue,3,4,7
2015,Agosto,Uzbekistán,2,0,2
2015,Julio,Suiza,923,1292,2215
2015,Julio,Chipre,3,10,13
2015,Septiembre,República Dominicana,567,866,1433
2015,Julio,Israel,216,799,1015
2015,Julio,Portugal,286,677,963
2015,Septiembre,Guyana,7,18,25
2015,Julio,Uruguay,330,580,910
2015,Julio,Italia,934,2319,3253
2015,Agosto,Grecia,45,79,124
2015,Septiembre,Omán,0,5,5
2015,Julio,Montserrat/Territorio Británico de Ultramar,1,0,1
2015,Septiembre,Camboya,3,3,6
2015,Septiembre,Bahréin,3,14,17
2015,Julio,Alemania,2294,2957,5251
2015,Julio,Montenegro,2,2,4
2015,Julio,Georgia,4,7,11
2015,Septiembre,Benín,0,8,8
2015,Septiembre,República Árabe Siria,0,5,5
2015,Agosto,Portugal,345,609,954
2015,Agosto,Emiratos Árabes,1,8,9
2015,Julio,Andorra,0,9,9
2015,Agosto,República de Kosovo,1,0,1
2015,Septiembre,Taiwán,73,112,185
2015,Julio,Pakistán,4,13,17
2015,Septiembre,República Árabe de Yemen,0,1,1
2015,Julio,Nueva Zelanda,116,164,280
2015,Julio,Nicaragua,72,137,209
2015,Julio,Senegal,4,5,9
2015,Agosto,Bosnia y Herzegovina,0,1,1
2015,Septiembre,Bulgaria,32,32,64
2015,Julio,Estonia,9,18,27
2015,Agosto,Barbados,10,9,19
2015,Julio,Etiopia,15,18,33
2015,Agosto,Eslovenia,13,31,44
2015,Julio,Gabón,0,1,1
2015,Agosto,Cuba,273,473,746
2015,Agosto,Haití,5,14,19
2015,Septiembre,Botsuana,1,2,3
2015,Septiembre,Camerún,1,10,11
2015,Agosto,Alemania,2597,3213,5810
2015,Septiembre,Australia,435,636,1071
2015,Septiembre,Hong Kong,4,1,5
2015,Agosto,Suecia,138,229,367
2015,Julio,Togo,0,1,1
2015,Septiembre,Bután,1,1,2
2015,Agosto,Senegal,1,4,5
2015,Julio,Sin especificar,43,111,154
2015,Septiembre,Panamá,2617,2847,5464
2015,Agosto,Mauricio,0,1,1
2015,Agosto,España,4088,7175,11263
2015,Julio,República de Corea,304,550,854
2015,Julio,Malasia,22,36,58
2015,Agosto,Austria,228,320,548
2015,Septiembre,Seychelles,2,1,3
2015,Septiembre,Egipto,4,33,37
2015,Agosto,Omán,0,2,2
2015,Agosto,Australia,412,649,1061
2015,Septiembre,Vietnam,2,5,7
2015,Agosto,Santa Lucia,3,9,12
2015,Agosto,Turquía,47,107,154
2015,Julio,Botsuana,1,5,6
2015,Agosto,San Marino,0,1,1
2015,Julio,Túnez,2,17,19
2015,Julio,Cuba,258,418,676
2015,Julio,Bangladesh,0,1,1
2015,Agosto,Mongolia,4,3,7
2015,Agosto,Brasil,4061,5928,9989
2015,Agosto,Bolivia,638,737,1375
2015,Julio,Uganda,2,5,7
2015,Julio,Japón,183,608,791
2015,Julio,Grecia,56,92,148
2015,Julio,Honduras,292,428,720
2015,Julio,Belice,11,18,29
2015,Agosto,Estonia,5,6,11
2015,Agosto,Gabón,0,1,1
2015,Agosto,Serbia,12,22,34
2015,Julio,Luxemburgo,13,9,22
2015,Agosto,Rumania,54,83,137
2015,Septiembre,Japón,225,547,772
2015,Septiembre,Namibia,1,2,3
2015,Agosto,Costa de Marfil,0,3,3
2015,Julio,Marruecos,6,26,32
2015,Agosto,Reino Unido de Gran Bretaña e Irlanda del Norte,1353,2472,3825
2015,Septiembre,Italia,995,2243,3238
2015,Agosto,Azerbaiyán,0,3,3
2015,Septiembre,Uzbekistán,1,1,2
2015,Septiembre,Suazilandia,0,2,2
2015,Septiembre,Filipinas,39,178,217
2015,Septiembre,Kirguistán,0,2,2
2015,Septiembre,Estados Unidos de América,10252,20358,30610
2015,Agosto,Angola,0,1,1
2015,Agosto,Etiopia,1,1,2
2015,Julio,Liberia,0,1,1
2015,Julio,Santa Lucia,6,6,12
2015,Septiembre,República de Irlanda,90,253,343
2015,Septiembre,Suecia,143,275,418
2015,Agosto,Islandia,3,8,11
2015,Agosto,Finlandia,44,50,94
2015,Julio,Bulgaria,20,31,51
2015,Julio,Haití,9,26,35
2015,Septiembre,Guinea Ecuatorial,0,1,1
2015,Septiembre,Surinam,25,28,53
2015,Agosto,Camboya,1,3,4
2015,Septiembre,Francia,1151,2241,3392
2015,Julio,Trinidad y Tobago,86,109,195
2015,Julio,Guinea Ecuatorial,1,1,2
2015,Julio,Paraguay,167,157,324
2015,Agosto,Camerún,0,7,7
2015,Septiembre,República de Armenia,1,4,5
2015,Agosto,Polonia,160,193,353
2015,Agosto,Argelia,3,10,13
2015,Julio,Filipinas,40,199,239
2015,Septiembre,Jordania,7,16,23
2015,Julio,Burkina Faso,1,1,2
2015,Agosto,Países Bajos,1296,1980,3276
2015,Julio,Guyana,6,18,24
2015,Agosto,Islas Fiji,0,2,2
2015,Septiembre,Costa de Marfil,2,11,13
2015,Julio,Zambia,0,3,3
2015,Agosto,Sin especificar,65,128,193
2015,Septiembre,Albania,3,3,6
2015,Julio,Indonesia,21,36,57
2015,Agosto,Mónaco,2,3,5
2015,Septiembre,Eritrea,2,1,3
2015,Septiembre,Honduras,344,554,898
2015,Agosto,Surinam,23,25,48
2015,Julio,Nepal,2,8,10
2015,Agosto,Malawi,3,5,8
2015,Septiembre,Gambia,0,1,1
2015,Septiembre,Ghana,1,14,15
2015,Agosto,Italia,1274,3092,4366
2015,Julio,Malta,4,4,8
2015,Julio,Canadá,1361,2013,3374
2015,Septiembre,Países Bajos,1155,1909,3064
2015,Julio,México,6422,10044,16466
2015,Julio,Guatemala,539,1097,1636
2015,Julio,Nigeria,4,15,19
2015,Agosto,Malí,0,2,2
2015,Julio,Angola,1,4,5
2015,Septiembre,Dominica,0,2,2
2015,Julio,Bermudas/Territorio Británico de Ultramar,3,7,10
2015,Septiembre,Ucrania,24,33,57
2015,Julio,República de Belarús,4,12,16
2015,Julio,Namibia,1,4,5
2015,Julio,Costa de Marfil,1,3,4
2015,Septiembre,Suiza,332,628,960
2015,Septiembre,Palestina,6,6,12
2015,Septiembre,Sin especificar,78,170,248
2015,Julio,Bahréin,6,7,13
2015,Septiembre,Rumania,56,89,145
2015,Septiembre,Etiopia,5,7,12
2015,Agosto,Kenia,4,20,24
2015,Agosto,Lesoto,1,0,1
2015,Septiembre,Bermudas/Territorio Británico de Ultramar,0,2,2
2015,Julio,Islas Turcas y Caicos/Territorio Británico de Ultramar,1,0,1
2015,Agosto,Bangladesh,1,4,5
2015,Agosto,República de Armenia,2,2,4
2015,Septiembre,Arabia Saudita,2,23,25
2015,Agosto,Islas Vírgenes Británicas/Territorio Británico de Ultramar,0,1,1
2015,Agosto,Andorra,3,10,13
2015,Septiembre,Sudáfrica,49,118,167
2015,Agosto,Federación de Rusia,193,215,408
2015,Septiembre,Islandia,4,8,12
2015,Julio,Seychelles,0,1,1
2015,Septiembre,Madagascar,0,6,6
2015,Agosto,Bahréin,0,3,3
2015,Agosto,Arabia Saudita,0,11,11
2015,Agosto,El Salvador,1149,1259,2408
2015,Julio,Líbano,18,32,50
2015,Agosto,Israel,226,771,997
2015,Agosto,Noruega,88,154,242
2015,Julio,Chad,0,2,2
2015,Septiembre,Chipre,4,6,10
2015,Agosto,Hong Kong,2,3,5
2015,Julio,Tailandia,8,8,16
2015,Septiembre,Guatemala,593,1266,1859
2015,Agosto,Egipto,12,27,39
2015,Agosto,Hungría,31,29,60
2015,Agosto,Filipinas,50,264,314
2015,Septiembre,San Cristóbal y Nevis,1,2,3
2015,Agosto,Sri Lanka,0,2,2
2015,Agosto,Chile,4390,5698,10088
2015,Septiembre,Singapur,21,22,43
2015,Agosto,Nepal,0,4,4
2015,Julio,Argelia,1,20,21
2015,Septiembre,Aruba,2,2,4
2015,Agosto,Malta,5,7,12
2015,Julio,Turquía,54,186,240
2015,Julio,Perú,6018,6942,12960
2015,Septiembre,Burkina Faso,1,1,2
2015,Septiembre,República Democrática del Congo,4,5,9
2015,Julio,Vietnam,6,4,10
2015,Julio,Países Bajos,2254,2920,5174
2015,Septiembre,Israel,199,646,845
2015,Julio,Panamá,2047,2633,4680
2015,Agosto,Tailandia,11,7,18
2015,Julio,Venezuela,15019,17183,32202
2015,Julio,República Árabe Siria,0,4,4
2015,Agosto,Canadá,1167,1833,3000
2015,Septiembre,Sierra Leona,0,1,1
2015,Septiembre,Liechtenstein,2,0,2
2015,Julio,República Democrática del Congo,0,5,5
2015,Julio,Hong Kong,5,2,7
2015,Julio,Austria,299,377,676
2015,Septiembre,Ecuador,5647,8063,13710
2015,Septiembre,Reino Unido de Gran Bretaña e Irlanda del Norte,1025,2106,3131
2015,Septiembre,Líbano,25,36,61
2015,Septiembre,Iraq,0,5,5
2015,Agosto,Tanzania,1,4,5
2015,Agosto,Granada,1,5,6
2015,Julio,Suazilandia,0,3,3
2015,Septiembre,Bangladesh,3,14,17
2015,Agosto,Mozambique,1,2,3
2015,Julio,Irán,9,18,27
2015,Julio,Dominica,4,6,10
2015,Julio,Francia,2681,3862,6543
2015,Agosto,Honduras,256,431,687
2015,Julio,República CentroÁfricana,1,0,1
2015,Julio,Ghana,3,20,23
2015,Agosto,San Cristóbal y Nevis,1,5,6
2015,Septiembre,Mongolia,7,5,12
2015,Agosto,Jordania,0,10,10
2015,Septiembre,Eslovaquia,17,23,40
2015,Septiembre,Anguila/Territorio Británico de Ultramar,0,1,1
2015,Septiembre,Granada,0,4,4
2015,Agosto,República de Corea,259,564,823
2015,Septiembre,Grecia,23,66,89
2015,Julio,China,430,902,1332
2015,Agosto,Croacia,18,46,64
2015,Julio,Palestina,2,1,3
2015,Septiembre,Tanzania,2,1,3
2015,Julio,Aruba,1,4,5
2015,Agosto,Myanmar,1,3,4
2015,Agosto,Bahamas,12,12,24
2015,Septiembre,Haití,8,25,33
2015,Julio,Bahamas,19,25,44
2015,Septiembre,Macedonia,0,1,1
2015,Septiembre,Bahamas,5,15,20
2015,Septiembre,Montenegro,3,4,7
2015,Agosto,Venezuela,19561,20667,40228
2015,Septiembre,Austria,140,265,405
2015,Septiembre,Angola,1,3,4
2015,Agosto,Kirguistán,1,1,2
2015,Septiembre,Cuba,370,586,956
2015,Septiembre,Malasia,17,72,89
2015,Septiembre,Sri Lanka,2,5,7
2015,Julio,Bosnia y Herzegovina,2,2,4
2015,Julio,San Marino,2,1,3
2015,Julio,Eslovaquia,33,30,63
2015,Agosto,Guatemala,534,1060,1594
2015,Septiembre,Uruguay,392,612,1004
2015,Agosto,Nicaragua,93,124,217
2015,Julio,Benín,0,2,2
2015,Agosto,Sudáfrica,69,139,208
2015,Septiembre,Togo,0,2,2
2015,Julio,Costa Rica,1217,1672,2889
2015,Septiembre,Costa Rica,994,1479,2473
2015,Agosto,Nueva Zelanda,88,120,208
2015,Julio,Serbia,15,18,33
2015,Agosto,Kazajistán,7,6,13
2015,Julio,Uzbekistán,5,7,12
2015,Septiembre,Argentina,4265,5549,9814
2015,Julio,Barbados,21,26,47
2015,Septiembre,Chad,0,3,3
2015,Septiembre,Trinidad y Tobago,31,73,104
2015,Septiembre,Dinamarca,75,166,241
2015,Agosto,República de Irlanda,159,252,411
2015,Septiembre,Kuwait,2,9,11
2015,Agosto,Palestina,0,1,1
2015,Septiembre,Nigeria,2,18,20
2015,Agosto,República Democrática Popular  Lao,0,1,1
2015,Julio,República de Kosovo,0,1,1
2015,Septiembre,Finlandia,32,83,115
2015,Julio,Qatar,0,5,5
2015,Julio,República de Moldavia,4,3,7
2015,Agosto,Bermudas/Territorio Británico de Ultramar,5,1,6
2015,Agosto,Malasia,21,35,56
2015,Septiembre,San Marino,0,2,2
2015,Julio,Emiratos Árabes,7,22,29
2015,Julio,Eslovenia,23,37,60
2015,Septiembre,Senegal,1,5,6
2015,Julio,Finlandia,74,59,133
2015,Septiembre,Mauricio,1,4,5
2015,Septiembre,República Checa,30,52,82
2015,Septiembre,Zimbabue,2,19,21
2015,Septiembre,Afganistán,1,2,3
2015,Agosto,Indonesia,18,37,55
2015,Agosto,Trinidad y Tobago,63,94,157
2015,Agosto,Chad,0,1,1
2015,Agosto,China,421,959,1380
2015,Agosto,San  Vicente y las Granadinas,2,8,10
2015,Agosto,Albania,2,6,8
2015,Julio,Australia,475,785,1260
2015,Septiembre,Noruega,59,155,214
2015,Julio,Estados Unidos de América,19240,28274,47514
2015,Septiembre,República Democrática de Timor Oriental,0,1,1
2015,Agosto,Montenegro,1,3,4
2015,Agosto,Sierra Leona,0,5,5
2015,Agosto,Macedonia,0,1,1
2015,Julio,Kuwait,1,3,4
2015,Agosto,Togo,0,1,1
2015,Julio,Sri Lanka,4,7,11
2015,Septiembre,Canadá,748,1478,2226
2015,Julio,Dinamarca,191,279,470
2015,Julio,Guinea Bissau,0,2,2
2015,Julio,Omán,0,5,5
2015,Agosto,República Checa,31,59,90
2015,Septiembre,República de Belarús,2,7,9
2015,Julio,Kenia,21,47,68
2015,Septiembre,Tailandia,12,17,29
2015,Septiembre,Brasil,5442,6550,11992
2015,Septiembre,España,2961,6980,9941
2015,Agosto,Georgia,2,3,5
2015,Septiembre,Emiratos Árabes,0,8,8
2015,Julio,India,82,449,531
2015,Septiembre,República Del Congo,0,4,4
2015,Agosto,Japón,217,549,766
2015,Julio,Polonia,117,184,301
2015,Agosto,Islas Caimán/Territorio Británico de Ultramar,3,5,8
2015,Agosto,Uganda,7,8,15
2015,Septiembre,Malta,4,8,12
2015,Julio,Argentina,4578,5777,10355
2015,Agosto,Taiwán,62,83,145
2015,Septiembre,Indonesia,9,27,36
2015,Julio,República Árabe de Yemen,0,1,1
2015,Septiembre,Letonia,4,14,18
2015,Octubre,Estados Unidos de América,10516,20838,31354
2015,Octubre,Venezuela,12192,13225,25417
2015,Octubre,Ecuador,6796,8800,15596
2015,Octubre,Perú,6556,7823,14379
2015,Octubre,Brasil,6129,6863,12992
2015,Octubre,México,4535,8025,12560
2015,Octubre,Argentina,4074,5774,9848
2015,Octubre,Chile,4442,5180,9622
2015,Octubre,España,2899,6635,9534
2015,Octubre,Panamá,3122,3462,6584
2015,Octubre,Alemania,1787,2942,4729
2015,Octubre,Francia,1456,2771,4227
2015,Octubre,Países Bajos,1454,2255,3709
2015,Octubre,Reino Unido de Gran Bretaña e Irlanda del Norte,1000,2301,3301
2015,Octubre,Italia,749,2312,3061
2015,Octubre,Canadá,990,1754,2744
2015,Octubre,Costa Rica,1085,1501,2586
2015,Octubre,El Salvador,957,1174,2131
2015,Octubre,Guatemala,668,1217,1885
2015,Octubre,Bolivia,673,838,1511
2015,Octubre,Suiza,476,839,1315
2015,Octubre,República Dominicana,538,713,1251
2015,Octubre,Australia,420,765,1185
2015,Octubre,China,351,799,1150
2015,Octubre,Portugal,343,675,1018
2015,Octubre,Uruguay,378,570,948
2015,Octubre,Honduras,443,502,945
2015,Octubre,Cuba,337,559,896
2015,Octubre,República de Corea,211,537,748
2015,Octubre,Israel,137,583,720
2015,Octubre,Japón,134,560,694
2015,Octubre,Paraguay,385,286,671
2015,Octubre,Bélgica,188,463,651
2015,Octubre,Suecia,216,361,577
2015,Octubre,Federación de Rusia,233,314,547
2015,Octubre,India,54,466,520
2015,Octubre,Polonia,136,264,400
2015,Octubre,Austria,124,247,371
2015,Octubre,Dinamarca,110,242,352
2015,Octubre,República de Irlanda,136,213,349
2015,Octubre,Filipinas,31,277,308
2015,Octubre,Noruega,117,173,290
2015,Octubre,Taiwán,123,144,267
2015,Octubre,Nueva Zelanda,89,145,234
2015,Octubre,Nicaragua,107,120,227
2015,Octubre,Turquía,33,148,181
2015,Octubre,Rumania,51,112,163
2015,Octubre,Finlandia,53,99,152
2015,Octubre,República Checa,39,102,141
2015,Octubre,Sudáfrica,43,98,141
2015,Octubre,Trinidad y Tobago,43,82,125
2015,Octubre,Jamaica,56,61,117
2015,Octubre,Hungría,47,68,115
2015,Octubre,Grecia,25,81,106
2015,Octubre,Ucrania,38,52,90
2015,Octubre,Tailandia,45,43,88
2015,Octubre,Croacia,11,63,74
2015,Octubre,Surinam,20,48,68
2015,Octubre,Lituania,35,30,65
2015,Octubre,Eslovaquia,27,36,63
2015,Octubre,Malasia,21,40,61
2015,Octubre,Bulgaria,23,35,58
2015,Octubre,Líbano,15,42,57
2015,Octubre,Indonesia,9,40,49
2015,Octubre,Barbados,15,28,43
2015,Octubre,Singapur,21,22,43
2015,Octubre,Eslovenia,12,29,41
2015,Octubre,Haití,11,30,41
2015,Octubre,Letonia,17,21,38
2015,Octubre,Guyana,13,19,32
2015,Octubre,Luxemburgo,11,21,32
2015,Octubre,República de Belarús,14,13,27
2015,Octubre,Egipto,11,15,26
2015,Octubre,Estonia,7,19,26
2015,Octubre,Islandia,13,13,26
2015,Octubre,Pakistán,8,16,24
2015,Octubre,Belice,6,16,22
2015,Octubre,Irán,0,20,20
2015,Octubre,Marruecos,8,12,20
2015,Octubre,Antigua y Barbuda,6,13,19
2015,Octubre,Bahamas,8,11,19
2015,Octubre,Hong Kong,12,4,16
2015,Octubre,Santa Lucia,4,11,15
2015,Octubre,Bermudas/Territorio Británico de Ultramar,6,8,14
2015,Octubre,Nepal,1,13,14
2015,Octubre,Azerbaiyán,3,10,13
2015,Octubre,Kazajistán,6,6,12
2015,Octubre,Kenia,6,6,12
2015,Octubre,Argelia,1,10,11
2015,Octubre,Malta,3,8,11
2015,Octubre,Vietnam,10,1,11
2015,Octubre,Andorra,1,8,9
2015,Octubre,San  Vicente y las Granadinas,3,6,9
2015,Octubre,Granada,2,6,8
2015,Octubre,Nigeria,1,7,8
2015,Octubre,Georgia,2,5,7
2015,Octubre,Kirguistán,1,6,7
2015,Octubre,Serbia,1,6,7
2015,Octubre,Arabia Saudita,0,6,6
2015,Octubre,Dominica,3,3,6
2015,Octubre,Emiratos Árabes,0,6,6
2015,Octubre,Mauricio,2,4,6
2015,Octubre,San Cristóbal y Nevis,2,4,6
2015,Octubre,Zimbabue,0,6,6
2015,Octubre,Chipre,1,4,5
2015,Octubre,Túnez,1,4,5
2015,Octubre,Uzbekistán,1,4,5
2015,Octubre,Albania,0,4,4
2015,Octubre,Bangladesh,1,3,4
2015,Octubre,Bosnia y Herzegovina,2,2,4
2015,Octubre,Islas Caimán/Territorio Británico de Ultramar,4,0,4
2015,Octubre,Camerún,0,4,4
2015,Octubre,República Democrática del Congo,1,3,4
2015,Octubre,Madagascar,2,2,4
2015,Octubre,Malí,2,2,4
2015,Octubre,Qatar,0,4,4
2015,Octubre,Zambia,2,2,4
2015,Octubre,Benín,0,3,3
2015,Octubre,Chad,1,2,3
2015,Octubre,Guinea,1,2,3
2015,Octubre,Jordania,1,2,3
2015,Octubre,Liechtenstein,1,2,3
2015,Octubre,Macedonia,0,3,3
2015,Octubre,Myanmar,1,2,3
2015,Octubre,Palestina,0,3,3
2015,Octubre,Senegal,0,3,3
2015,Octubre,República Árabe Siria,1,2,3
2015,Octubre,Sri Lanka,0,3,3
2015,Octubre,Uganda,2,1,3
2015,Octubre,Angola,0,2,2
2015,Octubre,Bahréin,0,2,2
2015,Octubre,Burundi,2,0,2
2015,Octubre,Costa de Marfil,0,2,2
2015,Octubre,Ghana,0,2,2
2015,Octubre,Kuwait,0,2,2
2015,Octubre,Mozambique,1,1,2
2015,Octubre,Tanzania,1,1,2
2015,Octubre,Togo,1,1,2
2015,Octubre,República Árabe de Yemen,0,2,2
2015,Octubre,República de Armenia,1,0,1
2015,Octubre,Cabo Verde,0,1,1
2015,Octubre,Etiopia,0,1,1
2015,Octubre,Gambia,1,0,1
2015,Octubre,Guinea Ecuatorial,1,0,1
2015,Octubre,Iraq,0,1,1
2015,Octubre,Kiribati,0,1,1
2015,Octubre,República de Kosovo,0,1,1
2015,Octubre,Mónaco,0,1,1
2015,Octubre,Mongolia,1,0,1
2015,Octubre,Micronesia,0,1,1
2015,Octubre,Namibia,0,1,1
2015,Octubre,Rwanda,1,0,1
2015,Octubre,Samoa Occidental,1,0,1
2015,Octubre,República de Tayikistán,0,1,1
2015,Octubre,Anguila/Territorio Británico de Ultramar,0,1,1
2015,Octubre,S/E,54,121,175
2015,Noviembre,Estados Unidos de América,12530,24026,36556
2015,Noviembre,Venezuela,12214,13777,25991
2015,Noviembre,México,4350,8727,13077
2015,Noviembre,Ecuador,5228,7535,12763
2015,Noviembre,Brasil,5228,6904,12132
2015,Noviembre,España,3406,7807,11213
2015,Noviembre,Perú,4754,6416,11170
2015,Noviembre,Argentina,4431,6296,10727
2015,Noviembre,Chile,3633,5310,8943
2015,Noviembre,Panamá,3574,3821,7395
2015,Noviembre,Alemania,1803,3218,5021
2015,Noviembre,Francia,1597,2913,4510
2015,Noviembre,Reino Unido de Gran Bretaña e Irlanda del Norte,1024,2543,3567
2015,Noviembre,Italia,756,2755,3511
2015,Noviembre,Países Bajos,1308,2116,3424
2015,Noviembre,Canadá,1203,2085,3288
2015,Noviembre,Costa Rica,1156,1716,2872
2015,Noviembre,El Salvador,1114,1437,2551
2015,Noviembre,Guatemala,806,1377,2183
2015,Noviembre,República Dominicana,688,1031,1719
2015,Noviembre,Bolivia,708,853,1561
2015,Noviembre,Australia,526,859,1385
2015,Noviembre,China,328,932,1260
2015,Noviembre,Suiza,435,804,1239
2015,Noviembre,Portugal,372,680,1052
2015,Noviembre,Cuba,397,627,1024
2015,Noviembre,Uruguay,349,671,1020
2015,Noviembre,Honduras,373,558,931
2015,Noviembre,República de Corea,277,620,897
2015,Noviembre,Paraguay,372,445,817
2015,Noviembre,Bélgica,238,549,787
2015,Noviembre,Japón,153,607,760
2015,Noviembre,Israel,133,600,733
2015,Noviembre,Suecia,244,442,686
2015,Noviembre,India,103,559,662
2015,Noviembre,Federación de Rusia,186,381,567
2015,Noviembre,Polonia,228,294,522
2015,Noviembre,Austria,159,334,493
2015,Noviembre,República de Irlanda,147,275,422
2015,Noviembre,Noruega,150,241,391
2015,Noviembre,Dinamarca,127,246,373
2015,Noviembre,Filipinas,41,310,351
2015,Noviembre,Nueva Zelanda,79,138,217
2015,Noviembre,Nicaragua,93,123,216
2015,Noviembre,República Checa,70,144,214
2015,Noviembre,Finlandia,87,121,208
2015,Noviembre,Rumania,68,133,201
2015,Noviembre,Taiwán,66,111,177
2015,Noviembre,Turquía,42,131,173
2015,Noviembre,Trinidad y Tobago,53,104,157
2015,Noviembre,Sudáfrica,44,99,143
2015,Noviembre,Grecia,18,92,110
2015,Noviembre,Hungría,48,49,97
2015,Noviembre,Surinam,38,46,84
2015,Noviembre,Croacia,11,70,81
2015,Noviembre,Indonesia,16,63,79
2015,Noviembre,Ucrania,21,52,73
2015,Noviembre,Bulgaria,31,41,72
2015,Noviembre,Jamaica,24,44,68
2015,Noviembre,Malasia,29,32,61
2015,Noviembre,Lituania,36,23,59
2015,Noviembre,Tailandia,39,20,59
2015,Noviembre,Eslovenia,16,36,52
2015,Noviembre,Eslovaquia,17,34,51
2015,Noviembre,Haití,14,32,46
2015,Noviembre,Singapur,16,28,44
2015,Noviembre,Líbano,13,24,37
2015,Noviembre,Belice,16,20,36
2015,Noviembre,Marruecos,5,25,30
2015,Noviembre,Egipto,3,24,27
2015,Noviembre,Antigua y Barbuda,8,18,26
2015,Noviembre,Barbados,12,14,26
2015,Noviembre,Estonia,8,17,25
2015,Noviembre,Guyana,9,16,25
2015,Noviembre,Luxemburgo,10,14,24
2015,Noviembre,Pakistán,4,19,23
2015,Noviembre,Serbia,8,14,22
2015,Noviembre,Letonia,10,11,21
2015,Noviembre,Kazajistán,3,15,18
2015,Noviembre,Malta,2,15,17
2015,Noviembre,Emiratos Árabes,0,16,16
2015,Noviembre,Irán,2,14,16
2015,Noviembre,Bahamas,7,8,15
2015,Noviembre,Santa Lucia,8,6,14
2015,Noviembre,Islandia,5,8,13
2015,Noviembre,Nigeria,3,10,13
2015,Noviembre,Dominica,3,9,12
2015,Noviembre,Jordania,3,9,12
2015,Noviembre,Andorra,1,10,11
2015,Noviembre,República de Belarús,5,6,11
2015,Noviembre,Kenia,4,7,11
2015,Noviembre,Túnez,2,9,11
2015,Noviembre,Arabia Saudita,1,9,10
2015,Noviembre,Camerún,1,9,10
2015,Noviembre,Georgia,5,5,10
2015,Noviembre,Bermudas/Territorio Británico de Ultramar,2,7,9
2015,Noviembre,Granada,2,7,9
2015,Noviembre,Sri Lanka,3,6,9
2015,Noviembre,Ghana,2,6,8
2015,Noviembre,Kirguistán,2,6,8
2015,Noviembre,Albania,2,5,7
2015,Noviembre,Chipre,4,3,7
2015,Noviembre,Etiopia,2,5,7
2015,Noviembre,Hong Kong,4,3,7
2015,Noviembre,San Cristóbal y Nevis,0,7,7
2015,Noviembre,Islas Caimán/Territorio Británico de Ultramar,2,4,6
2015,Noviembre,República Democrática del Congo,1,5,6
2015,Noviembre,Vietnam,3,3,6
2015,Noviembre,Argelia,3,2,5
2015,Noviembre,Bosnia y Herzegovina,2,3,5
2015,Noviembre,Costa de Marfil,0,5,5
2015,Noviembre,Liechtenstein,1,4,5
2015,Noviembre,República de Moldavia,4,1,5
2015,Noviembre,Nepal,1,4,5
2015,Noviembre,San  Vicente y las Granadinas,1,4,5
2015,Noviembre,Uganda,3,2,5
2015,Noviembre,Bangladesh,0,4,4
2015,Noviembre,Benín,1,3,4
2015,Noviembre,Macedonia,0,4,4
2015,Noviembre,Mauricio,1,3,4
2015,Noviembre,Aruba,2,1,3
2015,Noviembre,Bahréin,2,1,3
2015,Noviembre,Cabo Verde,0,3,3
2015,Noviembre,Guinea Ecuatorial,3,0,3
2015,Noviembre,Montenegro,0,3,3
2015,Noviembre,Omán,0,3,3
2015,Noviembre,República de Tayikistán,1,2,3
2015,Noviembre,Tanzania,0,3,3
2015,Noviembre,Zimbabue,0,3,3
2015,Noviembre,Anguila/Territorio Británico de Ultramar,2,1,3
2015,Noviembre,República de Armenia,0,2,2
2015,Noviembre,Azerbaiyán,0,2,2
2015,Noviembre,Kuwait,1,1,2
2015,Noviembre,Madagascar,1,1,2
2015,Noviembre,Mongolia,1,1,2
2015,Noviembre,Myanmar,1,1,2
2015,Noviembre,Palestina,0,2,2
2015,Noviembre,Senegal,0,2,2
2015,Noviembre,Sierra Leona,0,2,2
2015,Noviembre,República Árabe Siria,0,2,2
2015,Noviembre,Burundi,0,1,1
2015,Noviembre,Eritrea,0,1,1
2015,Noviembre,Islas Fiji,0,1,1
2015,Noviembre,Guinea,0,1,1
2015,Noviembre,Guinea Bissau,0,1,1
2015,Noviembre,República de Kosovo,0,1,1
2015,Noviembre,Mauritania,0,1,1
2015,Noviembre,Mozambique,0,1,1
2015,Noviembre,Qatar,0,1,1
2015,Noviembre,Samoa Occidental,1,0,1
2015,Noviembre,Sudán,0,1,1
2015,Noviembre,Turkmenistán,1,0,1
2015,Noviembre,Uzbekistán,1,0,1
2015,Noviembre,Zambia,0,1,1
2015,Noviembre,S/E,96,189,285
2015,Diciembre,Estados Unidos de América,22880,35461,58341
2015,Diciembre,Venezuela,13310,13736,27046
2015,Diciembre,Ecuador,6861,9119,15980
2015,Diciembre,Brasil,6870,6777,13647
2015,Diciembre,México,5284,7929,13213
2015,Diciembre,Argentina,4579,6314,10893
2015,Diciembre,España,3757,6919,10676
2015,Diciembre,Perú,4528,5707,10235
2015,Diciembre,Chile,3312,4521,7833
2015,Diciembre,Panamá,2751,3543,6294
2015,Diciembre,Canadá,2463,3439,5902
2015,Diciembre,Alemania,2298,3480,5778
2015,Diciembre,Francia,2174,3491,5665
2015,Diciembre,Reino Unido de Gran Bretaña e Irlanda del Norte,1639,3149,4788
2015,Diciembre,Países Bajos,1685,2638,4323
2015,Diciembre,Costa Rica,1846,2077,3923
2015,Diciembre,Italia,1141,2682,3823
2015,Diciembre,El Salvador,1037,1146,2183
2015,Diciembre,Guatemala,921,1174,2095
2015,Diciembre,Australia,769,1223,1992
2015,Diciembre,Suiza,711,1264,1975
2015,Diciembre,Bolivia,926,805,1731
2015,Diciembre,República Dominicana,577,809,1386
2015,Diciembre,Suecia,543,771,1314
2015,Diciembre,China,323,707,1030
2015,Diciembre,Cuba,373,555,928
2015,Diciembre,Honduras,456,436,892
2015,Diciembre,República de Corea,353,516,869
2015,Diciembre,Portugal,295,551,846
2015,Diciembre,Bélgica,269,540,809
2015,Diciembre,Japón,220,502,722
2015,Diciembre,Israel,150,549,699
2015,Diciembre,Uruguay,247,443,690
2015,Diciembre,India,104,519,623
2015,Diciembre,Austria,238,359,597
2015,Diciembre,Noruega,214,277,491
2015,Diciembre,Federación de Rusia,206,249,455
2015,Diciembre,Dinamarca,172,275,447
2015,Diciembre,Paraguay,248,194,442
2015,Diciembre,República de Irlanda,112,249,361
2015,Diciembre,Polonia,146,195,341
2015,Diciembre,Filipinas,52,273,325
2015,Diciembre,Nueva Zelanda,116,179,295
2015,Diciembre,Finlandia,114,164,278
2015,Diciembre,Nicaragua,120,94,214
2015,Diciembre,Turquía,53,144,197
2015,Diciembre,Grecia,53,111,164
2015,Diciembre,República Checa,75,86,161
2015,Diciembre,Rumania,69,86,155
2015,Diciembre,Trinidad y Tobago,36,98,134
2015,Diciembre,Sudáfrica,46,83,129
2015,Diciembre,Taiwán,64,59,123
2015,Diciembre,Singapur,38,53,91
2015,Diciembre,Hungría,36,48,84
2015,Diciembre,Croacia,14,59,73
2015,Diciembre,Lituania,38,35,73
2015,Diciembre,Ucrania,38,35,73
2015,Diciembre,Indonesia,25,46,71
2015,Diciembre,Eslovenia,23,36,59
2015,Diciembre,Tailandia,41,17,58
2015,Diciembre,Eslovaquia,22,35,57
2015,Diciembre,Bulgaria,27,26,53
2015,Diciembre,Jamaica,17,34,51
2015,Diciembre,Malasia,24,21,45
2015,Diciembre,Líbano,13,29,42
2015,Diciembre,Arabia Saudita,2,35,37
2015,Diciembre,Luxemburgo,16,19,35
2015,Diciembre,Serbia,20,13,33
2015,Diciembre,Islandia,10,21,31
2015,Diciembre,Haití,10,19,29
2015,Diciembre,Letonia,10,19,29
2015,Diciembre,Marruecos,8,21,29
2015,Diciembre,Malta,9,19,28
2015,Diciembre,Guyana,6,21,27
2015,Diciembre,Estonia,8,18,26
2015,Diciembre,Irán,6,19,25
2015,Diciembre,Egipto,5,19,24
2015,Diciembre,Myanmar,3,19,22
2015,Diciembre,Barbados,6,15,21
2015,Diciembre,Jordania,6,14,20
2015,Diciembre,Surinam,6,12,18
2015,Diciembre,Kuwait,2,12,14
2015,Diciembre,Pakistán,2,12,14
2015,Diciembre,Emiratos Árabes,2,11,13
2015,Diciembre,Liechtenstein,5,8,13
2015,Diciembre,Belice,2,9,11
2015,Diciembre,Kenia,5,5,10
2015,Diciembre,Túnez,2,8,10
2015,Diciembre,Andorra,2,7,9
2015,Diciembre,Argelia,3,5,8
2015,Diciembre,República de Belarús,4,4,8
2015,Diciembre,Islas Caimán/Territorio Británico de Ultramar,2,6,8
2015,Diciembre,Georgia,1,7,8
2015,Diciembre,San Marino,1,7,8
2015,Diciembre,Vietnam,6,2,8
2015,Diciembre,Antigua y Barbuda,0,7,7
2015,Diciembre,Bahamas,1,6,7
2015,Diciembre,Chipre,2,5,7
2015,Diciembre,Kazajistán,4,3,7
2015,Diciembre,Montenegro,2,5,7
2015,Diciembre,San Cristóbal y Nevis,2,5,7
2015,Diciembre,Santa Lucia,4,3,7
2015,Diciembre,Bosnia y Herzegovina,1,5,6
2015,Diciembre,Ghana,0,6,6
2015,Diciembre,Nigeria,2,4,6
2015,Diciembre,Omán,0,6,6
2015,Diciembre,Bahréin,1,4,5
2015,Diciembre,Granada,1,4,5
2015,Diciembre,Nepal,3,2,5
2015,Diciembre,San  Vicente y las Granadinas,2,3,5
2015,Diciembre,Uzbekistán,3,2,5
2015,Diciembre,Aruba,0,4,4
2015,Diciembre,Azerbaiyán,1,3,4
2015,Diciembre,Bermudas/Territorio Británico de Ultramar,1,3,4
2015,Diciembre,Macedonia,1,3,4
2015,Diciembre,Mozambique,2,2,4
2015,Diciembre,Sri Lanka,3,1,4
2015,Diciembre,Albania,0,3,3
2015,Diciembre,Angola,0,3,3
2015,Diciembre,República de Armenia,2,1,3
2015,Diciembre,Bangladesh,0,3,3
2015,Diciembre,Mauricio,1,2,3
2015,Diciembre,Uganda,1,2,3
2015,Diciembre,Benín,0,2,2
2015,Diciembre,Dominica,0,2,2
2015,Diciembre,Guinea Ecuatorial,2,0,2
2015,Diciembre,República de Moldavia,2,0,2
2015,Diciembre,Mongolia,1,1,2
2015,Diciembre,República Árabe Siria,0,2,2
2015,Diciembre,Sudán,0,2,2
2015,Diciembre,Togo,0,2,2
2015,Diciembre,Zimbabue,0,2,2
2015,Diciembre,Botsuana,1,0,1
2015,Diciembre,Camerún,1,0,1
2015,Diciembre,Comoras,0,1,1
2015,Diciembre,República Democrática del Congo,1,0,1
2015,Diciembre,Islas Fiji,1,0,1
2015,Diciembre,Guinea,0,1,1
2015,Diciembre,Guam/Territorio no incorporado de Estados Unidos,1,0,1
2015,Diciembre,Hong Kong,1,0,1
2015,Diciembre,Iraq,0,1,1
2015,Diciembre,Kiribati,0,1,1
2015,Diciembre,República de Kosovo,0,1,1
2015,Diciembre,Namibia,0,1,1
2015,Diciembre,Palestina,0,1,1
2015,Diciembre,Puerto Rico/Territorio de Estados Unidos,0,1,1
2015,Diciembre,Qatar,0,1,1
2015,Diciembre,Rwanda,0,1,1
2015,Diciembre,Santa Sede/Ciudad del Vaticano,0,1,1
2015,Diciembre,Senegal,1,0,1
2015,Diciembre,Somalia,0,1,1
2015,Diciembre,República Árabe de Yemen,0,1,1
2015,Diciembre,Zambia,0,1,1
2015,Diciembre,S/E,33,90,123
2016,Enero,Estados Unidos de América,13383,23649,37032
2016,Enero,Venezuela,10701,12098,22799
2016,Enero,Brasil,8946,8873,17819
2016,Enero,Argentina,8323,8375,16698
2016,Enero,México,4495,7470,11965
2016,Enero,Ecuador,4475,6682,11157
2016,Enero,Perú,4979,6145,11124
2016,Enero,España,3188,6730,9918
2016,Enero,Chile,4429,5276,9705
2016,Enero,Francia,2484,3627,6111
2016,Enero,Panamá,2869,3060,5929
2016,Enero,Canadá,2338,3280,5618
2016,Enero,Reino Unido de Gran Bretaña e Irlanda del Norte,2141,3364,5505
2016,Enero,Alemania,2193,3277,5470
2016,Enero,Italia,1313,2953,4266
2016,Enero,Países Bajos,1394,2219,3613
2016,Enero,Costa Rica,1455,1644,3099
2016,Enero,El Salvador,848,1092,1940
2016,Enero,Bolivia,862,956,1818
2016,Enero,Suiza,680,1022,1702
2016,Enero,Australia,637,1004,1641
2016,Enero,Guatemala,521,889,1410
2016,Enero,China,397,826,1223
2016,Enero,República Dominicana,495,716,1211
2016,Enero,Portugal,418,773,1191
2016,Enero,República de Corea,494,687,1181
2016,Enero,Uruguay,393,535,928
2016,Enero,Israel,192,704,896
2016,Enero,Suecia,341,522,863
2016,Enero,Japón,227,559,786
2016,Enero,Bélgica,258,527,785
2016,Enero,Federación de Rusia,315,429,744
2016,Enero,Honduras,320,381,701
2016,Enero,Paraguay,357,320,677
2016,Enero,India,93,545,638
2016,Enero,Cuba,231,376,607
2016,Enero,Austria,199,358,557
2016,Enero,Polonia,192,322,514
2016,Enero,Dinamarca,190,304,494
2016,Enero,Noruega,172,240,412
2016,Enero,República de Irlanda,125,255,380
2016,Enero,Filipinas,43,226,269
2016,Enero,Nueva Zelanda,82,151,233
2016,Enero,Turquía,50,180,230
2016,Enero,Nicaragua,111,109,220
2016,Enero,Finlandia,80,115,195
2016,Enero,Rumania,69,113,182
2016,Enero,República Checa,69,94,163
2016,Enero,Taiwán,65,96,161
2016,Enero,Sudáfrica,59,95,154
2016,Enero,Grecia,41,112,153
2016,Enero,Hungría,51,65,116
2016,Enero,Trinidad y Tobago,27,77,104
2016,Enero,Ucrania,37,59,96
2016,Enero,Croacia,19,71,90
2016,Enero,Eslovaquia,31,59,90
2016,Enero,Eslovenia,41,49,90
2016,Enero,Bulgaria,38,51,89
2016,Enero,Jamaica,39,44,83
2016,Enero,Lituania,39,32,71
2016,Enero,Singapur,22,39,61
2016,Enero,Malasia,24,35,59
2016,Enero,Serbia,21,37,58
2016,Enero,Letonia,15,31,46
2016,Enero,Haití,15,30,45
2016,Enero,Egipto,11,33,44
2016,Enero,Líbano,17,24,41
2016,Enero,Indonesia,11,28,39
2016,Enero,Surinam,14,25,39
2016,Enero,Islandia,16,21,37
2016,Enero,Marruecos,12,23,35
2016,Enero,Guyana,12,20,32
2016,Enero,Estonia,11,19,30
2016,Enero,Barbados,13,14,27
2016,Enero,Malta,12,14,26
2016,Enero,Luxemburgo,10,13,23
2016,Enero,Nigeria,5,18,23
2016,Enero,Pakistán,8,15,23
2016,Enero,Bahamas,9,12,21
2016,Enero,Irán,6,13,19
2016,Enero,Kenia,7,9,16
2016,Enero,Belice,4,11,15
2016,Enero,Tailandia,9,6,15
2016,Enero,República de Belarús,3,11,14
2016,Enero,Kazajistán,7,7,14
2016,Enero,Andorra,3,10,13
2016,Enero,Georgia,2,10,12
2016,Enero,Túnez,1,11,12
2016,Enero,Antigua y Barbuda,1,10,11
2016,Enero,Arabia Saudita,2,9,11
2016,Enero,Jordania,3,8,11
2016,Enero,Granada,2,7,9
2016,Enero,Vietnam,1,8,9
2016,Enero,Albania,3,5,8
2016,Enero,Chipre,2,6,8
2016,Enero,Kuwait,3,5,8
2016,Enero,Santa Lucia,5,3,8
2016,Enero,Zimbabue,2,6,8
2016,Enero,Dominica,1,6,7
2016,Enero,Ghana,1,6,7
2016,Enero,Liechtenstein,2,5,7
2016,Enero,Argelia,3,3,6
2016,Enero,Islas Caimán/Territorio Británico de Ultramar,2,4,6
2016,Enero,Nepal,2,4,6
2016,Enero,San Cristóbal y Nevis,2,4,6
2016,Enero,República Democrática del Congo,1,4,5
2016,Enero,Macedonia,2,3,5
2016,Enero,República CentroÁfricana,5,0,5
2016,Enero,Sri Lanka,2,3,5
2016,Enero,Azerbaiyán,2,2,4
2016,Enero,Bermudas/Territorio Británico de Ultramar,0,4,4
2016,Enero,Camerún,2,2,4
2016,Enero,Emiratos Árabes,1,3,4
2016,Enero,Guinea Ecuatorial,0,4,4
2016,Enero,Myanmar,0,4,4
2016,Enero,San  Vicente y las Granadinas,0,4,4
2016,Enero,Bangladesh,0,3,3
2016,Enero,Bosnia y Herzegovina,1,2,3
2016,Enero,Costa de Marfil,0,3,3
2016,Enero,República de Kosovo,0,3,3
2016,Enero,Malí,1,2,3
2016,Enero,República de Moldavia,3,0,3
2016,Enero,Qatar,0,3,3
2016,Enero,República Árabe Siria,0,3,3
2016,Enero,Uganda,1,2,3
2016,Enero,República de Armenia,2,0,2
2016,Enero,Aruba,2,0,2
2016,Enero,Burkina Faso,0,2,2
2016,Enero,Cabo Verde,1,1,2
2016,Enero,República Del Congo,0,2,2
2016,Enero,Etiopia,0,2,2
2016,Enero,Iraq,0,2,2
2016,Enero,Madagascar,1,1,2
2016,Enero,Mauricio,0,2,2
2016,Enero,Mónaco,1,1,2
2016,Enero,Montenegro,0,2,2
2016,Enero,Mozambique,1,1,2
2016,Enero,Palestina,1,1,2
2016,Enero,Santa Sede/Ciudad del Vaticano,0,2,2
2016,Enero,Senegal,1,1,2
2016,Enero,Sierra Leona,0,2,2
2016,Enero,Tanzania,0,2,2
2016,Enero,Zambia,1,1,2
2016,Enero,Bahréin,0,1,1
2016,Enero,Benín,1,0,1
2016,Enero,Islas Salomón,1,0,1
2016,Enero,República Democrática Popular  Lao,0,1,1
2016,Enero,Libia,0,1,1
2016,Enero,Malawi,1,0,1
2016,Enero,Mongolia,0,1,1
2016,Enero,Omán,0,1,1
2016,Enero,República Árabe de Yemen,0,1,1
2016,Enero,Anguila/Territorio Británico de Ultramar,0,1,1
2016,Enero,S/E,43,103,146
2016,Febrero,Estados Unidos de América,14716,25943,40659
2016,Febrero,Brasil,8964,9161,18125
2016,Febrero,Venezuela,7625,9819,17444
2016,Febrero,Argentina,6183,7315,13498
2016,Febrero,Ecuador,5650,7442,13092
2016,Febrero,Perú,6102,6902,13004
2016,Febrero,Chile,6385,6491,12876
2016,Febrero,México,3523,7178,10701
2016,Febrero,España,2734,6339,9073
2016,Febrero,Panamá,4724,4331,9055
2016,Febrero,Francia,2426,3595,6021
2016,Febrero,Alemania,2391,3458,5849
2016,Febrero,Canadá,2260,3053,5313
2016,Febrero,Reino Unido de Gran Bretaña e Irlanda del Norte,1389,2626,4015
2016,Febrero,Italia,1059,2565,3624
2016,Febrero,Países Bajos,1387,2154,3541
2016,Febrero,Costa Rica,885,1300,2185
2016,Febrero,El Salvador,778,1095,1873
2016,Febrero,Suiza,659,983,1642
2016,Febrero,Guatemala,484,992,1476
2016,Febrero,Bolivia,627,729,1356
2016,Febrero,República Dominicana,495,712,1207
2016,Febrero,Australia,404,729,1133
2016,Febrero,China,352,701,1053
2016,Febrero,Japón,320,662,982
2016,Febrero,Portugal,276,654,930
2016,Febrero,Israel,207,703,910
2016,Febrero,República de Corea,292,506,798
2016,Febrero,Uruguay,295,496,791
2016,Febrero,Bélgica,256,515,771
2016,Febrero,Austria,296,430,726
2016,Febrero,Suecia,295,428,723
2016,Febrero,Paraguay,377,317,694
2016,Febrero,Honduras,283,384,667
2016,Febrero,Polonia,230,333,563
2016,Febrero,India,74,482,556
2016,Febrero,Dinamarca,210,326,536
2016,Febrero,Federación de Rusia,202,278,480
2016,Febrero,Filipinas,128,343,471
2016,Febrero,Cuba,146,265,411
2016,Febrero,República de Irlanda,118,264,382
2016,Febrero,Noruega,135,221,356
2016,Febrero,Nicaragua,115,115,230
2016,Febrero,Turquía,47,162,209
2016,Febrero,Nueva Zelanda,67,132,199
2016,Febrero,Sudáfrica,44,150,194
2016,Febrero,República Checa,62,126,188
2016,Febrero,Rumania,61,99,160
2016,Febrero,Finlandia,65,92,157
2016,Febrero,Taiwán,73,80,153
2016,Febrero,Grecia,30,115,145
2016,Febrero,República de Belarús,29,80,109
2016,Febrero,Bulgaria,50,51,101
2016,Febrero,Hungría,43,55,98
2016,Febrero,Trinidad y Tobago,24,74,98
2016,Febrero,Ucrania,26,72,98
2016,Febrero,Croacia,26,60,86
2016,Febrero,Jamaica,31,43,74
2016,Febrero,Emiratos Árabes,5,67,72
2016,Febrero,Eslovenia,33,39,72
2016,Febrero,Lituania,34,35,69
2016,Febrero,Surinam,22,37,59
2016,Febrero,Eslovaquia,26,32,58
2016,Febrero,Malasia,33,25,58
2016,Febrero,Letonia,14,30,44
2016,Febrero,Egipto,5,35,40
2016,Febrero,Indonesia,13,24,37
2016,Febrero,Singapur,13,21,34
2016,Febrero,Serbia,10,23,33
2016,Febrero,Malta,9,23,32
2016,Febrero,Líbano,16,13,29
2016,Febrero,Islandia,12,16,28
2016,Febrero,Barbados,12,14,26
2016,Febrero,Kenia,8,18,26
2016,Febrero,Pakistán,4,20,24
2016,Febrero,Tailandia,18,6,24
2016,Febrero,Georgia,2,20,22
2016,Febrero,Luxemburgo,10,12,22
2016,Febrero,Estonia,8,13,21
2016,Febrero,Marruecos,9,12,21
2016,Febrero,Belice,5,15,20
2016,Febrero,Haití,3,16,19
2016,Febrero,Guyana,11,7,18
2016,Febrero,Irán,5,12,17
2016,Febrero,Andorra,3,12,15
2016,Febrero,Ghana,1,14,15
2016,Febrero,Nigeria,6,7,13
2016,Febrero,Antigua y Barbuda,4,8,12
2016,Febrero,Bahamas,6,6,12
2016,Febrero,Kazajistán,9,3,12
2016,Febrero,República de Armenia,2,8,10
2016,Febrero,Chipre,6,4,10
2016,Febrero,Myanmar,1,9,10
2016,Febrero,Arabia Saudita,0,8,8
2016,Febrero,Argelia,3,4,7
2016,Febrero,Costa de Marfil,0,7,7
2016,Febrero,Dominica,0,7,7
2016,Febrero,Kuwait,2,5,7
2016,Febrero,República de Moldavia,2,5,7
2016,Febrero,Túnez,2,5,7
2016,Febrero,Islas Caimán/Territorio Británico de Ultramar,5,1,6
2016,Febrero,Jordania,1,5,6
2016,Febrero,Santa Lucia,1,5,6
2016,Febrero,Sri Lanka,4,2,6
2016,Febrero,Vietnam,4,2,6
2016,Febrero,Albania,3,2,5
2016,Febrero,Camerún,0,5,5
2016,Febrero,República de Kosovo,3,2,5
2016,Febrero,Palestina,0,5,5
2016,Febrero,Uganda,2,3,5
2016,Febrero,Azerbaiyán,1,3,4
2016,Febrero,Bermudas/Territorio Británico de Ultramar,1,3,4
2016,Febrero,Cabo Verde,2,2,4
2016,Febrero,República Democrática del Congo,2,2,4
2016,Febrero,Granada,2,2,4
2016,Febrero,Mónaco,4,0,4
2016,Febrero,Nepal,1,3,4
2016,Febrero,Aruba,1,2,3
2016,Febrero,Bahréin,1,2,3
2016,Febrero,Bangladesh,1,2,3
2016,Febrero,Liechtenstein,1,2,3
2016,Febrero,Macedonia,1,2,3
2016,Febrero,Madagascar,3,0,3
2016,Febrero,Mauricio,0,3,3
2016,Febrero,Montenegro,1,2,3
2016,Febrero,Omán,0,3,3
2016,Febrero,San Marino,1,2,3
2016,Febrero,Senegal,0,3,3
2016,Febrero,Togo,1,2,3
2016,Febrero,Uzbekistán,1,2,3
2016,Febrero,Zambia,1,2,3
2016,Febrero,Etiopia,1,1,2
2016,Febrero,Iraq,0,2,2
2016,Febrero,Malí,0,2,2
2016,Febrero,Mongolia,2,0,2
2016,Febrero,Mozambique,2,0,2
2016,Febrero,Rwanda,1,1,2
2016,Febrero,San Cristóbal y Nevis,0,2,2
2016,Febrero,Sierra Leona,2,0,2
2016,Febrero,República Árabe Siria,0,2,2
2016,Febrero,Sudán,0,2,2
2016,Febrero,República de Tayikistán,0,2,2
2016,Febrero,Tanzania,2,0,2
2016,Febrero,Afganistán,0,1,1
2016,Febrero,Angola,0,1,1
2016,Febrero,Bosnia y Herzegovina,1,0,1
2016,Febrero,Islas Fiji,0,1,1
2016,Febrero,Gabón,0,1,1
2016,Febrero,Hong Kong,0,1,1
2016,Febrero,Kiribati,0,1,1
2016,Febrero,República CentroÁfricana,0,1,1
2016,Febrero,San  Vicente y las Granadinas,0,1,1
2016,Febrero,Santa Sede/Ciudad del Vaticano,0,1,1
2016,Febrero,República Árabe de Yemen,0,1,1
2016,Febrero,Zimbabue,0,1,1
2016,Febrero,Anguila/Territorio Británico de Ultramar,0,1,1
2016,Febrero,S/E,52,121,173
2016,Marzo,Estados Unidos de América,17133,27756,44889
2016,Marzo,Venezuela,8634,10145,18779
2016,Marzo,Ecuador,6943,9635,16578
2016,Marzo,Brasil,7458,7613,15071
2016,Marzo,México,5299,8736,14035
2016,Marzo,Argentina,6034,7326,13360
2016,Marzo,Perú,5306,6237,11543
2016,Marzo,España,3315,6718,10033
2016,Marzo,Chile,4179,5317,9496
2016,Marzo,Panamá,3410,3794,7204
2016,Marzo,Alemania,2488,3519,6007
2016,Marzo,Reino Unido de Gran Bretaña e Irlanda del Norte,1912,3078,4990
2016,Marzo,Canadá,2065,2811,4876
2016,Marzo,Francia,1807,2920,4727
2016,Marzo,Países Bajos,1441,2061,3502
2016,Marzo,Italia,945,2313,3258
2016,Marzo,Costa Rica,1252,1737,2989
2016,Marzo,El Salvador,1225,1351,2576
2016,Marzo,Guatemala,870,1191,2061
2016,Marzo,República Dominicana,743,828,1571
2016,Marzo,Suiza,552,860,1412
2016,Marzo,China,421,953,1374
2016,Marzo,Bolivia,647,723,1370
2016,Marzo,Israel,314,1043,1357
2016,Marzo,Uruguay,427,695,1122
2016,Marzo,Australia,397,640,1037
2016,Marzo,Honduras,495,530,1025
2016,Marzo,Portugal,327,659,986
2016,Marzo,Japón,244,588,832
2016,Marzo,República de Corea,268,531,799
2016,Marzo,Suecia,313,460,773
2016,Marzo,Bélgica,267,468,735
2016,Marzo,Paraguay,366,300,666
2016,Marzo,Austria,206,442,648
2016,Marzo,India,94,446,540
2016,Marzo,Federación de Rusia,198,301,499
2016,Marzo,Dinamarca,175,310,485
2016,Marzo,Cuba,165,303,468
2016,Marzo,Noruega,189,266,455
2016,Marzo,República de Irlanda,173,252,425
2016,Marzo,Polonia,187,235,422
2016,Marzo,Filipinas,40,275,315
2016,Marzo,Turquía,69,190,259
2016,Marzo,Nicaragua,129,128,257
2016,Marzo,Finlandia,78,129,207
2016,Marzo,Taiwán,85,114,199
2016,Marzo,Nueva Zelanda,81,117,198
2016,Marzo,República Checa,59,104,163
2016,Marzo,Sudáfrica,67,93,160
2016,Marzo,Grecia,40,114,154
2016,Marzo,Rumania,53,97,150
2016,Marzo,Trinidad y Tobago,45,87,132
2016,Marzo,Hungría,48,58,106
2016,Marzo,Eslovenia,29,56,85
2016,Marzo,Jamaica,34,47,81
2016,Marzo,Bulgaria,26,49,75
2016,Marzo,Haití,31,41,72
2016,Marzo,Ucrania,17,48,65
2016,Marzo,Eslovaquia,28,31,59
2016,Marzo,Lituania,28,31,59
2016,Marzo,Croacia,19,36,55
2016,Marzo,Indonesia,9,36,45
2016,Marzo,Malasia,16,29,45
2016,Marzo,Barbados,14,27,41
2016,Marzo,Surinam,18,23,41
2016,Marzo,Singapur,13,26,39
2016,Marzo,Islandia,13,25,38
2016,Marzo,Líbano,10,28,38
2016,Marzo,Tailandia,19,12,31
2016,Marzo,Serbia,13,16,29
2016,Marzo,Pakistán,12,16,28
2016,Marzo,Arabia Saudita,0,25,25
2016,Marzo,Marruecos,5,20,25
2016,Marzo,Irán,7,16,23
2016,Marzo,Luxemburgo,7,15,22
2016,Marzo,Nigeria,5,17,22
2016,Marzo,Chipre,6,15,21
2016,Marzo,Estonia,12,8,20
2016,Marzo,Guyana,7,13,20
2016,Marzo,Malta,5,15,20
2016,Marzo,Letonia,9,10,19
2016,Marzo,Andorra,2,15,17
2016,Marzo,Emiratos Árabes,1,16,17
2016,Marzo,Egipto,2,14,16
2016,Marzo,Jordania,3,12,15
2016,Marzo,Belice,2,12,14
2016,Marzo,Antigua y Barbuda,3,10,13
2016,Marzo,Bahamas,6,7,13
2016,Marzo,República de Belarús,5,7,12
2016,Marzo,Bermudas/Territorio Británico de Ultramar,4,8,12
2016,Marzo,Ghana,1,11,12
2016,Marzo,Kazajistán,8,4,12
2016,Marzo,Santa Lucia,7,5,12
2016,Marzo,Azerbaiyán,2,9,11
2016,Marzo,Kenia,3,8,11
2016,Marzo,Vietnam,8,2,10
2016,Marzo,Argelia,3,6,9
2016,Marzo,Bangladesh,0,9,9
2016,Marzo,Dominica,4,5,9
2016,Marzo,San  Vicente y las Granadinas,2,7,9
2016,Marzo,Mauricio,1,7,8
2016,Marzo,Albania,3,4,7
2016,Marzo,Islas Caimán/Territorio Británico de Ultramar,2,5,7
2016,Marzo,Kirguistán,4,3,7
2016,Marzo,Malí,2,5,7
2016,Marzo,República Democrática del Congo,1,5,6
2016,Marzo,Etiopia,1,5,6
2016,Marzo,Granada,1,5,6
2016,Marzo,Hong Kong,4,2,6
2016,Marzo,Sri Lanka,2,4,6
2016,Marzo,Zimbabue,3,3,6
2016,Marzo,Camerún,1,4,5
2016,Marzo,Kuwait,0,5,5
2016,Marzo,Liberia,1,4,5
2016,Marzo,Nepal,1,4,5
2016,Marzo,San Cristóbal y Nevis,1,4,5
2016,Marzo,Uganda,1,4,5
2016,Marzo,República de Armenia,3,1,4
2016,Marzo,Bosnia y Herzegovina,0,4,4
2016,Marzo,Georgia,2,2,4
2016,Marzo,Liechtenstein,1,3,4
2016,Marzo,Macedonia,1,3,4
2016,Marzo,Mozambique,1,3,4
2016,Marzo,Sudán,1,3,4
2016,Marzo,Tanzania,2,2,4
2016,Marzo,Togo,1,3,4
2016,Marzo,Túnez,0,4,4
2016,Marzo,Aruba,1,2,3
2016,Marzo,Cabo Verde,0,3,3
2016,Marzo,Costa de Marfil,1,2,3
2016,Marzo,República de Moldavia,2,1,3
2016,Marzo,Mónaco,3,0,3
2016,Marzo,Montenegro,1,2,3
2016,Marzo,Islas Vírgenes Británicas/Territorio Británico de Ultramar,1,2,3
2016,Marzo,Botsuana,0,2,2
2016,Marzo,Bután,0,2,2
2016,Marzo,Senegal,1,1,2
2016,Marzo,Sierra Leona,0,2,2
2016,Marzo,Brunei Darussalam,0,1,1
2016,Marzo,Burkina Faso,0,1,1
2016,Marzo,Islas Fiji,0,1,1
2016,Marzo,Gambia,1,0,1
2016,Marzo,Guinea,1,0,1
2016,Marzo,Guinea Ecuatorial,0,1,1
2016,Marzo,República de Kosovo,1,0,1
2016,Marzo,Madagascar,0,1,1
2016,Marzo,Malawi,0,1,1
2016,Marzo,Namibia,0,1,1
2016,Marzo,Omán,1,0,1
2016,Marzo,Palestina,0,1,1
2016,Marzo,República CentroÁfricana,1,0,1
2016,Marzo,Rwanda,1,0,1
2016,Marzo,Samoa Occidental,1,0,1
2016,Marzo,Santa Sede/Ciudad del Vaticano,0,1,1
2016,Marzo,República de Tayikistán,0,1,1
2016,Marzo,Uzbekistán,1,0,1
2016,Marzo,S/E,94,164,258
2016,Abril,Estados Unidos de América,13079,24162,37241
2016,Abril,Brasil,8493,8864,17357
2016,Abril,Venezuela,7336,9065,16401
2016,Abril,Ecuador,5776,7418,13194
2016,Abril,México,4037,7903,11940
2016,Abril,Argentina,5079,6359,11438
2016,Abril,Perú,4353,5518,9871
2016,Abril,Chile,3817,4931,8748
2016,Abril,España,2401,5970,8371
2016,Abril,Panamá,3991,3900,7891
2016,Abril,Francia,1688,2798,4486
2016,Abril,Países Bajos,1673,2349,4022
2016,Abril,Alemania,1397,2408,3805
2016,Abril,Reino Unido de Gran Bretaña e Irlanda del Norte,1225,2329,3554
2016,Abril,Canadá,1055,1859,2914
2016,Abril,Italia,687,2030,2717
2016,Abril,Costa Rica,1054,1475,2529
2016,Abril,El Salvador,952,1200,2152
2016,Abril,Israel,576,1494,2070
2016,Abril,Guatemala,499,1003,1502
2016,Abril,Bolivia,600,757,1357
2016,Abril,República Dominicana,580,699,1279
2016,Abril,Suiza,486,736,1222
2016,Abril,China,351,868,1219
2016,Abril,Australia,388,708,1096
2016,Abril,Honduras,401,506,907
2016,Abril,Uruguay,324,503,827
2016,Abril,Portugal,193,521,714
2016,Abril,República de Corea,176,452,628
2016,Abril,Paraguay,345,257,602
2016,Abril,Suecia,243,353,596
2016,Abril,Japón,131,458,589
2016,Abril,Cuba,211,376,587
2016,Abril,India,75,447,522
2016,Abril,Bélgica,157,353,510
2016,Abril,Federación de Rusia,161,239,400
2016,Abril,República de Irlanda,150,249,399
2016,Abril,Filipinas,42,339,381
2016,Abril,Polonia,128,250,378
2016,Abril,Austria,116,246,362
2016,Abril,Dinamarca,118,201,319
2016,Abril,Noruega,78,173,251
2016,Abril,Nicaragua,91,134,225
2016,Abril,Nueva Zelanda,71,140,211
2016,Abril,Turquía,33,164,197
2016,Abril,Sudáfrica,50,103,153
2016,Abril,República Checa,63,88,151
2016,Abril,Finlandia,60,91,151
2016,Abril,Rumania,46,88,134
2016,Abril,Taiwán,40,88,128
2016,Abril,Trinidad y Tobago,30,65,95
2016,Abril,Grecia,21,56,77
2016,Abril,Ucrania,18,55,73
2016,Abril,Hungría,25,38,63
2016,Abril,Bulgaria,20,42,62
2016,Abril,Eslovaquia,21,41,62
2016,Abril,Croacia,9,45,54
2016,Abril,Jamaica,20,31,51
2016,Abril,Surinam,24,26,50
2016,Abril,Indonesia,17,29,46
2016,Abril,Egipto,7,38,45
2016,Abril,Malasia,16,26,42
2016,Abril,Singapur,16,23,39
2016,Abril,Líbano,14,24,38
2016,Abril,Lituania,21,14,35
2016,Abril,Tailandia,20,15,35
2016,Abril,Eslovenia,3,30,33
2016,Abril,Serbia,11,20,31
2016,Abril,Kenia,14,16,30
2016,Abril,Haití,9,18,27
2016,Abril,Vietnam,6,20,26
2016,Abril,Barbados,9,15,24
2016,Abril,Guyana,11,11,22
2016,Abril,Irán,6,14,20
2016,Abril,Letonia,10,9,19
2016,Abril,Nigeria,6,13,19
2016,Abril,Belice,2,16,18
2016,Abril,Emiratos Árabes,5,13,18
2016,Abril,Marruecos,10,8,18
2016,Abril,Estonia,9,8,17
2016,Abril,Pakistán,4,13,17
2016,Abril,Islandia,9,7,16
2016,Abril,Túnez,7,9,16
2016,Abril,Bahamas,4,10,14
2016,Abril,Antigua y Barbuda,2,11,13
2016,Abril,Ghana,3,10,13
2016,Abril,Luxemburgo,5,8,13
2016,Abril,República de Armenia,9,3,12
2016,Abril,Andorra,4,7,11
2016,Abril,Malta,5,6,11
2016,Abril,Jordania,2,7,9
2016,Abril,Uganda,5,4,9
2016,Abril,Dominica,3,5,8
2016,Abril,Kazajistán,5,3,8
2016,Abril,Santa Lucia,3,5,8
2016,Abril,Senegal,2,6,8
2016,Abril,Albania,0,7,7
2016,Abril,República Democrática del Congo,5,2,7
2016,Abril,Islas Caimán/Territorio Británico de Ultramar,4,2,6
2016,Abril,Palestina,1,5,6
2016,Abril,Zambia,2,4,6
2016,Abril,Zimbabue,4,2,6
2016,Abril,Arabia Saudita,0,5,5
2016,Abril,Bangladesh,0,5,5
2016,Abril,República de Belarús,4,1,5
2016,Abril,Bermudas/Territorio Británico de Ultramar,1,4,5
2016,Abril,Bosnia y Herzegovina,0,5,5
2016,Abril,Burundi,1,4,5
2016,Abril,Sierra Leona,1,4,5
2016,Abril,República Árabe Siria,0,5,5
2016,Abril,Tanzania,0,5,5
2016,Abril,Angola,0,4,4
2016,Abril,Argelia,2,2,4
2016,Abril,Botsuana,0,4,4
2016,Abril,Chipre,1,3,4
2016,Abril,Etiopia,0,4,4
2016,Abril,Granada,2,2,4
2016,Abril,Mauricio,0,4,4
2016,Abril,Mozambique,1,3,4
2016,Abril,Myanmar,0,4,4
2016,Abril,Nepal,2,2,4
2016,Abril,Benín,2,1,3
2016,Abril,Cabo Verde,3,0,3
2016,Abril,Georgia,1,2,3
2016,Abril,Lesoto,2,1,3
2016,Abril,República de Moldavia,1,2,3
2016,Abril,Rwanda,2,1,3
2016,Abril,San Cristóbal y Nevis,0,3,3
2016,Abril,San  Vicente y las Granadinas,0,3,3
2016,Abril,Sri Lanka,1,2,3
2016,Abril,Togo,0,3,3
2016,Abril,Aruba,2,0,2
2016,Abril,Camboya,0,2,2
2016,Abril,Costa de Marfil,0,2,2
2016,Abril,Eritrea,0,2,2
2016,Abril,Gabón,0,2,2
2016,Abril,República de Kosovo,0,2,2
2016,Abril,Liechtenstein,1,1,2
2016,Abril,Macedonia,2,0,2
2016,Abril,Montenegro,1,1,2
2016,Abril,República CentroÁfricana,1,1,2
2016,Abril,Uzbekistán,2,0,2
2016,Abril,Afganistán,0,1,1
2016,Abril,Camerún,0,1,1
2016,Abril,Chad,0,1,1
2016,Abril,Islas Fiji,0,1,1
2016,Abril,Guinea,0,1,1
2016,Abril,Hong Kong,1,0,1
2016,Abril,Iraq,1,0,1
2016,Abril,Islas Salomón,0,1,1
2016,Abril,Liberia,0,1,1
2016,Abril,Madagascar,1,0,1
2016,Abril,Malí,1,0,1
2016,Abril,Mauritania,0,1,1
2016,Abril,Qatar,0,1,1
2016,Abril,Samoa Estadounidense/Territorio no incorporado de Estados Unidos,0,1,1
2016,Abril,San Marino,0,1,1
2016,Abril,República de Tayikistán,0,1,1
2016,Abril,S/E,52,121,173
2016,Mayo,Estados Unidos de América,13807,24629,38436
2016,Mayo,Venezuela,7624,9739,17363
2016,Mayo,Brasil,7327,8088,15415
2016,Mayo,México,4292,8320,12612
2016,Mayo,Ecuador,4342,6848,11190
2016,Mayo,Argentina,4510,6384,10894
2016,Mayo,Perú,4667,5968,10635
2016,Mayo,Chile,4352,5527,9879
2016,Mayo,España,2356,5992,8348
2016,Mayo,Panamá,2794,3067,5861
2016,Mayo,Francia,1442,2592,4034
2016,Mayo,Alemania,1410,2408,3818
2016,Mayo,Países Bajos,1475,2166,3641
2016,Mayo,Reino Unido de Gran Bretaña e Irlanda del Norte,1246,2364,3610
2016,Mayo,Canadá,1089,1874,2963
2016,Mayo,Italia,640,1904,2544
2016,Mayo,Costa Rica,1019,1465,2484
2016,Mayo,El Salvador,876,1176,2052
2016,Mayo,Guatemala,551,1189,1740
2016,Mayo,Israel,478,1233,1711
2016,Mayo,Bolivia,679,741,1420
2016,Mayo,China,383,964,1347
2016,Mayo,Australia,442,791,1233
2016,Mayo,Suiza,398,715,1113
2016,Mayo,República Dominicana,426,678,1104
2016,Mayo,Uruguay,364,564,928
2016,Mayo,Honduras,334,430,764
2016,Mayo,República de Corea,194,514,708
2016,Mayo,Japón,146,533,679
2016,Mayo,Cuba,202,466,668
2016,Mayo,Portugal,185,478,663
2016,Mayo,India,86,532,618
2016,Mayo,Bélgica,170,406,576
2016,Mayo,Turquía,173,392,565
2016,Mayo,Paraguay,259,226,485
2016,Mayo,Suecia,174,287,461
2016,Mayo,República de Irlanda,152,297,449
2016,Mayo,Federación de Rusia,155,226,381
2016,Mayo,Austria,128,217,345
2016,Mayo,Nueva Zelanda,124,190,314
2016,Mayo,Dinamarca,113,195,308
2016,Mayo,Polonia,112,169,281
2016,Mayo,Filipinas,36,223,259
2016,Mayo,Noruega,83,153,236
2016,Mayo,Nicaragua,67,126,193
2016,Mayo,República Checa,68,100,168
2016,Mayo,Taiwán,56,111,167
2016,Mayo,Rumania,63,100,163
2016,Mayo,Sudáfrica,46,93,139
2016,Mayo,Finlandia,54,68,122
2016,Mayo,Grecia,34,72,106
2016,Mayo,Trinidad y Tobago,15,82,97
2016,Mayo,Lituania,26,43,69
2016,Mayo,Surinam,20,46,66
2016,Mayo,Hungría,24,41,65
2016,Mayo,Bulgaria,27,37,64
2016,Mayo,Jamaica,22,38,60
2016,Mayo,Indonesia,11,47,58
2016,Mayo,Singapur,20,37,57
2016,Mayo,Ucrania,24,33,57
2016,Mayo,Eslovaquia,16,39,55
2016,Mayo,Letonia,10,45,55
2016,Mayo,Malasia,17,36,53
2016,Mayo,Croacia,11,35,46
2016,Mayo,Líbano,12,32,44
2016,Mayo,Eslovenia,10,30,40
2016,Mayo,Barbados,12,27,39
2016,Mayo,Islandia,11,19,30
2016,Mayo,Egipto,5,23,28
2016,Mayo,Estonia,13,15,28
2016,Mayo,Nigeria,7,20,27
2016,Mayo,Tailandia,11,16,27
2016,Mayo,Belice,8,18,26
2016,Mayo,Haití,8,18,26
2016,Mayo,Pakistán,7,18,25
2016,Mayo,Serbia,7,18,25
2016,Mayo,Arabia Saudita,0,24,24
2016,Mayo,Guyana,10,14,24
2016,Mayo,Andorra,6,15,21
2016,Mayo,Bahamas,5,13,18
2016,Mayo,Luxemburgo,4,14,18
2016,Mayo,Ghana,4,13,17
2016,Mayo,Malta,4,13,17
2016,Mayo,Kenia,5,9,14
2016,Mayo,Marruecos,4,10,14
2016,Mayo,Sri Lanka,2,12,14
2016,Mayo,Túnez,2,9,11
2016,Mayo,Antigua y Barbuda,2,8,10
2016,Mayo,Azerbaiyán,3,7,10
2016,Mayo,Irán,3,7,10
2016,Mayo,Jordania,3,6,9
2016,Mayo,Zimbabue,1,8,9
2016,Mayo,República de Belarús,1,7,8
2016,Mayo,Emiratos Árabes,2,6,8
2016,Mayo,Georgia,2,6,8
2016,Mayo,Kazajistán,6,2,8
2016,Mayo,Vietnam,5,3,8
2016,Mayo,Chipre,2,5,7
2016,Mayo,Hong Kong,1,6,7
2016,Mayo,San  Vicente y las Granadinas,2,4,6
2016,Mayo,Bermudas/Territorio Británico de Ultramar,1,4,5
2016,Mayo,Sierra Leona,0,1,1
2016,Mayo,Islas Caimán/Territorio Británico de Ultramar,5,0,5
2016,Mayo,Etiopia,0,5,5
2016,Mayo,República CentroÁfricana,5,0,5
2016,Mayo,San Cristóbal y Nevis,0,5,5
2016,Mayo,Santa Lucia,1,4,5
2016,Mayo,Albania,1,3,4
2016,Mayo,Bangladesh,1,3,4
2016,Mayo,Granada,2,2,4
2016,Mayo,Liechtenstein,3,1,4
2016,Mayo,Nepal,2,2,4
2016,Mayo,Rwanda,1,3,4
2016,Mayo,Senegal,1,3,4
2016,Mayo,República Árabe Siria,1,3,4
2016,Mayo,Zambia,1,3,4
2016,Mayo,Bahréin,1,2,3
2016,Mayo,Bosnia y Herzegovina,1,2,3
2016,Mayo,Camerún,0,3,3
2016,Mayo,República Democrática del Congo,1,2,3
2016,Mayo,Dominica,0,3,3
2016,Mayo,Kuwait,1,2,3
2016,Mayo,Macedonia,1,2,3
2016,Mayo,Mauricio,1,2,3
2016,Mayo,Afganistán,0,2,2
2016,Mayo,Angola,1,1,2
2016,Mayo,Argelia,0,2,2
2016,Mayo,Burkina Faso,1,1,2
2016,Mayo,Guinea Bissau,1,1,2
2016,Mayo,Iraq,1,1,2
2016,Mayo,República de Moldavia,2,0,2
2016,Mayo,Mozambique,1,1,2
2016,Mayo,Santa Sede/Ciudad del Vaticano,0,2,2
2016,Mayo,Sudán,1,1,2
2016,Mayo,Uganda,1,1,2
2016,Mayo,Uzbekistán,1,1,2
2016,Mayo,República Árabe de Yemen,0,2,2
2016,Mayo,República de Armenia,1,0,1
2016,Mayo,Botsuana,1,0,1
2016,Mayo,Brunei Darussalam,0,1,1
2016,Mayo,Burundi,1,0,1
2016,Mayo,Camboya,1,0,1
2016,Mayo,Guernsey,0,1,1
2016,Mayo,Islas Heard Y Mcdonald,1,0,1
2016,Mayo,Guinea Ecuatorial,0,1,1
2016,Mayo,Islas Salomón,0,1,1
2016,Mayo,Kirguistán,1,0,1
2016,Mayo,República de Kosovo,0,1,1
2016,Mayo,Mongolia,1,0,1
2016,Mayo,Montenegro,0,1,1
2016,Mayo,Myanmar,0,1,1
2016,Mayo,Namibia,1,0,1
2016,Mayo,Palestina,0,1,1
2016,Mayo,Samoa Estadounidense/Territorio no incorporado de Estados Unidos,0,1,1
2016,Mayo,República de Tayikistán,1,0,1
2016,Mayo,Islas Vírgenes Británicas/Territorio Británico de Ultramar,0,1,1
2016,Mayo,Islas Turcas y Caicos/Territorio Británico de Ultramar,0,1,1
2016,Mayo,S/E,69,128,197
2016,Junio,Estados Unidos de América,21657,31232,52889
2016,Junio,Venezuela,8224,10301,18525
2016,Junio,México,5245,9014,14259
2016,Junio,Perú,5841,7648,13489
2016,Junio,Brasil,5359,6908,12267
2016,Junio,Ecuador,4376,6630,11006
2016,Junio,Chile,4228,5740,9968
2016,Junio,España,3059,6500,9559
2016,Junio,Argentina,3642,5547,9189
2016,Junio,Panamá,3851,3626,7477
2016,Junio,Francia,1522,2503,4025
2016,Junio,Alemania,1382,2198,3580
2016,Junio,Reino Unido de Gran Bretaña e Irlanda del Norte,1242,2192,3434
2016,Junio,Países Bajos,1331,1923,3254
2016,Junio,Canadá,1031,1799,2830
2016,Junio,Italia,729,2076,2805
2016,Junio,Costa Rica,1174,1545,2719
2016,Junio,El Salvador,907,1195,2102
2016,Junio,Guatemala,697,1180,1877
2016,Junio,Bolivia,786,855,1641
2016,Junio,República Dominicana,581,742,1323
2016,Junio,China,367,884,1251
2016,Junio,Suiza,486,707,1193
2016,Junio,Australia,455,705,1160
2016,Junio,Israel,285,768,1053
2016,Junio,Uruguay,408,613,1021
2016,Junio,República de Corea,258,535,793
2016,Junio,Bélgica,291,500,791
2016,Junio,Honduras,327,445,772
2016,Junio,Suecia,295,423,718
2016,Junio,Paraguay,343,285,628
2016,Junio,Japón,132,480,612
2016,Junio,Cuba,184,403,587
2016,Junio,India,96,479,575
2016,Junio,Portugal,150,394,544
2016,Junio,Turquía,162,342,504
2016,Junio,Noruega,190,266,456
2016,Junio,Dinamarca,150,229,379
2016,Junio,República de Irlanda,131,235,366
2016,Junio,Austria,126,216,342
2016,Junio,Federación de Rusia,127,214,341
2016,Junio,Polonia,107,194,301
2016,Junio,Nicaragua,148,139,287
2016,Junio,Filipinas,38,219,257
2016,Junio,Nueva Zelanda,97,154,251
2016,Junio,Taiwán,87,89,176
2016,Junio,Sudáfrica,49,107,156
2016,Junio,República Checa,50,87,137
2016,Junio,Finlandia,48,85,133
2016,Junio,Rumania,54,71,125
2016,Junio,Grecia,25,83,108
2016,Junio,Trinidad y Tobago,25,65,90
2016,Junio,Jamaica,18,69,87
2016,Junio,Ucrania,24,61,85
2016,Junio,Hungría,23,54,77
2016,Junio,Croacia,14,49,63
2016,Junio,Lituania,25,34,59
2016,Junio,Malasia,22,34,56
2016,Junio,Eslovenia,18,30,48
2016,Junio,Bulgaria,19,28,47
2016,Junio,Eslovaquia,18,29,47
2016,Junio,Surinam,12,35,47
2016,Junio,Singapur,13,29,42
2016,Junio,Haití,9,31,40
2016,Junio,Kazajistán,22,13,35
2016,Junio,Indonesia,10,22,32
2016,Junio,Letonia,12,19,31
2016,Junio,Barbados,10,17,27
2016,Junio,Egipto,5,22,27
2016,Junio,Líbano,9,17,26
2016,Junio,Tailandia,17,9,26
2016,Junio,Pakistán,5,20,25
2016,Junio,Bahamas,10,13,23
2016,Junio,Malta,9,14,23
2016,Junio,Estonia,9,12,21
2016,Junio,Guyana,3,18,21
2016,Junio,Irán,5,16,21
2016,Junio,Nigeria,4,17,21
2016,Junio,Belice,8,12,20
2016,Junio,Kenia,5,15,20
2016,Junio,Islandia,10,9,19
2016,Junio,Luxemburgo,3,12,15
2016,Junio,Etiopia,1,13,14
2016,Junio,Vietnam,4,10,14
2016,Junio,Santa Lucia,5,8,13
2016,Junio,República de Belarús,5,7,12
2016,Junio,Marruecos,6,6,12
2016,Junio,Andorra,1,9,10
2016,Junio,Antigua y Barbuda,2,7,9
2016,Junio,Serbia,4,5,9
2016,Junio,Sri Lanka,4,5,9
2016,Junio,Georgia,1,7,8
2016,Junio,Hong Kong,2,6,8
2016,Junio,Rwanda,1,7,8
2016,Junio,Jordania,3,4,7
2016,Junio,República Árabe Siria,5,2,7
2016,Junio,Túnez,3,4,7
2016,Junio,Islas Caimán/Territorio Británico de Ultramar,2,4,6
2016,Junio,Granada,1,5,6
2016,Junio,Arabia Saudita,0,5,5
2016,Junio,Argelia,1,4,5
2016,Junio,República Democrática del Congo,0,5,5
2016,Junio,Chipre,2,3,5
2016,Junio,Dominica,3,2,5
2016,Junio,Ghana,2,3,5
2016,Junio,Mauricio,1,4,5
2016,Junio,República de Moldavia,5,0,5
2016,Junio,Camerún,2,2,4
2016,Junio,Liechtenstein,3,1,4
2016,Junio,Macedonia,0,4,4
2016,Junio,Myanmar,1,3,4
2016,Junio,San Cristóbal y Nevis,1,3,4
2016,Junio,San  Vicente y las Granadinas,2,2,4
2016,Junio,Tanzania,1,3,4
2016,Junio,Albania,1,2,3
2016,Junio,Bermudas/Territorio Británico de Ultramar,0,3,3
2016,Junio,Costa de Marfil,2,1,3
2016,Junio,Madagascar,3,0,3
2016,Junio,Namibia,1,2,3
2016,Junio,Palestina,2,1,3
2016,Junio,Zambia,1,2,3
2016,Junio,Zimbabue,0,3,3
2016,Junio,Angola,0,2,2
2016,Junio,Azerbaiyán,2,0,2
2016,Junio,Bahréin,1,1,2
2016,Junio,Bangladesh,1,1,2
2016,Junio,Emiratos Árabes,1,1,2
2016,Junio,Iraq,0,2,2
2016,Junio,Nepal,1,1,2
2016,Junio,Omán,0,2,2
2016,Junio,República CentroÁfricana,2,0,2
2016,Junio,Santa Sede/Ciudad del Vaticano,0,2,2
2016,Junio,Senegal,1,1,2
2016,Junio,Bosnia y Herzegovina,1,0,1
2016,Junio,Botsuana,1,0,1
2016,Junio,Burkina Faso,0,1,1
2016,Junio,Cabo Verde,1,0,1
2016,Junio,Chad,0,1,1
2016,Junio,Eritrea,0,1,1
2016,Junio,Guinea Ecuatorial,1,0,1
2016,Junio,Islas Salomón,1,0,1
2016,Junio,Kiribati,0,1,1
2016,Junio,Kirguistán,0,1,1
2016,Junio,Kuwait,1,0,1
2016,Junio,República de Kosovo,0,1,1
2016,Junio,Lesoto,0,1,1
2016,Junio,Libia,0,1,1
2016,Junio,Montenegro,0,1,1
2016,Junio,San Marino,1,0,1
2016,Junio,Uzbekistán,1,0,1
2016,Junio,República Árabe de Yemen,0,1,1
2016,Junio,S/E,80,168,248
2016,Julio,Estados Unidos de América,21438,30321,51759
2016,Julio,Venezuela,12398,14099,26497
2016,Julio,México,6779,9792,16571
2016,Julio,Ecuador,6661,8759,15420
2016,Julio,Brasil,6825,7627,14452
2016,Julio,Perú,6440,7108,13548
2016,Julio,Argentina,5232,6413,11645
2016,Julio,Chile,5431,6009,11440
2016,Julio,España,3664,6808,10472
2016,Julio,Francia,2924,3980,6904
2016,Julio,Panamá,3356,3522,6878
2016,Julio,Países Bajos,2846,3434,6280
2016,Julio,Alemania,2470,3107,5577
2016,Julio,Reino Unido de Gran Bretaña e Irlanda del Norte,1779,2750,4529
2016,Julio,Costa Rica,1712,1975,3687
2016,Julio,Canadá,1522,2123,3645
2016,Julio,Italia,958,2038,2996
2016,Julio,El Salvador,1095,1271,2366
2016,Julio,Suiza,1001,1333,2334
2016,Julio,Bolivia,890,917,1807
2016,Julio,República Dominicana,734,963,1697
2016,Julio,Guatemala,558,1113,1671
2016,Julio,Australia,510,789,1299
2016,Julio,Bélgica,532,735,1267
2016,Julio,China,398,820,1218
2016,Julio,Israel,292,803,1095
2016,Julio,Honduras,419,569,988
2016,Julio,Uruguay,412,565,977
2016,Julio,Japón,214,584,798
2016,Julio,República de Corea,276,483,759
2016,Julio,Cuba,263,453,716
2016,Julio,Portugal,193,457,650
2016,Julio,Austria,274,352,626
2016,Julio,India,82,493,575
2016,Julio,Turquía,204,339,543
2016,Julio,Suecia,215,289,504
2016,Julio,Paraguay,241,259,500
2016,Julio,Dinamarca,205,284,489
2016,Julio,República de Irlanda,192,288,480
2016,Julio,Noruega,184,260,444
2016,Julio,Polonia,168,238,406
2016,Julio,Federación de Rusia,178,200,378
2016,Julio,Filipinas,54,252,306
2016,Julio,Nueva Zelanda,117,176,293
2016,Julio,Nicaragua,102,141,243
2016,Julio,Taiwán,81,109,190
2016,Julio,Sudáfrica,56,92,148
2016,Julio,Rumania,60,79,139
2016,Julio,Trinidad y Tobago,60,79,139
2016,Julio,Finlandia,56,64,120
2016,Julio,Grecia,42,76,118
2016,Julio,República Checa,50,57,107
2016,Julio,Hungría,38,52,90
2016,Julio,Qatar,1,89,90
2016,Julio,Jamaica,38,41,79
2016,Julio,Lituania,34,33,67
2016,Julio,Ucrania,28,35,63
2016,Julio,Eslovenia,25,36,61
2016,Julio,Líbano,25,34,59
2016,Julio,Eslovaquia,26,28,54
2016,Julio,Croacia,9,44,53
2016,Julio,Indonesia,19,30,49
2016,Julio,Haití,15,33,48
2016,Julio,Vietnam,23,24,47
2016,Julio,Bulgaria,20,26,46
2016,Julio,Egipto,8,35,43
2016,Julio,Luxemburgo,19,22,41
2016,Julio,Singapur,20,21,41
2016,Julio,Barbados,16,24,40
2016,Julio,Estonia,15,25,40
2016,Julio,Belice,15,24,39
2016,Julio,Tailandia,27,10,37
2016,Julio,Marruecos,13,23,36
2016,Julio,Kenia,13,19,32
2016,Julio,Malasia,14,16,30
2016,Julio,Surinam,10,19,29
2016,Julio,Emiratos Árabes,6,22,28
2016,Julio,Guyana,13,14,27
2016,Julio,Letonia,8,19,27
2016,Julio,Bahamas,14,12,26
2016,Julio,Irán,7,18,25
2016,Julio,Serbia,9,13,22
2016,Julio,Hong Kong,5,13,18
2016,Julio,Malta,5,13,18
2016,Julio,Arabia Saudita,1,16,17
2016,Julio,República de Belarús,7,8,15
2016,Julio,Ghana,0,14,14
2016,Julio,Andorra,1,12,13
2016,Julio,Islandia,4,9,13
2016,Julio,Georgia,6,6,12
2016,Julio,Pakistán,1,11,12
2016,Julio,Islas Caimán/Territorio Británico de Ultramar,6,5,11
2016,Julio,Chipre,4,7,11
2016,Julio,Kuwait,3,7,10
2016,Julio,Nigeria,4,6,10
2016,Julio,República Democrática del Congo,5,4,9
2016,Julio,Albania,3,4,7
2016,Julio,Jordania,2,5,7
2016,Julio,Liechtenstein,2,5,7
2016,Julio,Sri Lanka,1,6,7
2016,Julio,Argelia,1,5,6
2016,Julio,Bosnia y Herzegovina,2,4,6
2016,Julio,Dominica,1,5,6
2016,Julio,Etiopia,3,3,6
2016,Julio,Mauricio,2,4,6
2016,Julio,Mónaco,3,3,6
2016,Julio,Burkina Faso,0,5,5
2016,Julio,Camboya,1,4,5
2016,Julio,Myanmar,2,3,5
2016,Julio,Santa Lucia,1,4,5
2016,Julio,Túnez,1,4,5
2016,Julio,Antigua y Barbuda,0,4,4
2016,Julio,Bangladesh,1,3,4
2016,Julio,Cabo Verde,4,0,4
2016,Julio,Granada,2,2,4
2016,Julio,Macedonia,1,3,4
2016,Julio,Azerbaiyán,0,3,3
2016,Julio,Benín,1,2,3
2016,Julio,Bermudas/Territorio Británico de Ultramar,0,3,3
2016,Julio,Camerún,0,3,3
2016,Julio,Eritrea,1,2,3
2016,Julio,Kazajistán,3,0,3
2016,Julio,Mongolia,3,0,3
2016,Julio,Nepal,1,2,3
2016,Julio,Palestina,3,0,3
2016,Julio,San Cristóbal y Nevis,1,2,3
2016,Julio,Zimbabue,1,2,3
2016,Julio,Angola,1,1,2
2016,Julio,Bahréin,2,0,2
2016,Julio,Gabón,0,2,2
2016,Julio,Mauritania,1,1,2
2016,Julio,Montenegro,1,1,2
2016,Julio,Mozambique,1,1,2
2016,Julio,Omán,0,2,2
2016,Julio,San  Vicente y las Granadinas,1,1,2
2016,Julio,Senegal,1,1,2
2016,Julio,Islas Vírgenes Británicas/Territorio Británico de Ultramar,1,1,2
2016,Julio,República de Armenia,0,1,1
2016,Julio,Botsuana,1,0,1
2016,Julio,Costa de Marfil,1,0,1
2016,Julio,Islas Fiji,1,0,1
2016,Julio,Guinea,1,0,1
2016,Julio,Guinea Ecuatorial,0,1,1
2016,Julio,Isla de Man,1,0,1
2016,Julio,República de Kosovo,0,1,1
2016,Julio,República Democrática Popular  Lao,0,1,1
2016,Julio,Madagascar,1,0,1
2016,Julio,Samoa Estadounidense/Territorio no incorporado de Estados Unidos,0,1,1
2016,Julio,Santo Tomé y Príncipe,0,1,1
2016,Julio,República Árabe Siria,0,1,1
2016,Julio,Somalia,0,1,1
2016,Julio,Togo,0,1,1
2016,Julio,Uganda,1,0,1
2016,Julio,Uzbekistán,1,0,1
2016,Julio,Anguila/Territorio Británico de Ultramar,0,1,1
2016,Julio,S/E,58,140,198
2016,Agosto,Venezuela,28764,30935,59699
2016,Agosto,Estados Unidos de América,16373,27323,43696
2016,Agosto,Ecuador,9423,11180,20603
2016,Agosto,México,5383,9428,14811
2016,Agosto,Perú,6064,7134,13198
2016,Agosto,Brasil,6004,7167,13171
2016,Agosto,Chile,5757,6600,12357
2016,Agosto,Argentina,4767,7034,11801
2016,Agosto,España,4308,7352,11660
2016,Agosto,Panamá,4014,4276,8290
2016,Agosto,Francia,2496,3685,6181
2016,Agosto,Alemania,2617,3256,5873
2016,Agosto,Italia,1431,3018,4449
2016,Agosto,Países Bajos,1689,2382,4071
2016,Agosto,Reino Unido de Gran Bretaña e Irlanda del Norte,1370,2269,3639
2016,Agosto,Costa Rica,1350,1961,3311
2016,Agosto,Canadá,1223,1979,3202
2016,Agosto,El Salvador,1427,1565,2992
2016,Agosto,Guatemala,760,1455,2215
2016,Agosto,República Dominicana,944,1148,2092
2016,Agosto,China,417,994,1411
2016,Agosto,Bolivia,595,718,1313
2016,Agosto,Australia,487,781,1268
2016,Agosto,Suiza,536,700,1236
2016,Agosto,Uruguay,433,718,1151
2016,Agosto,Israel,285,826,1111
2016,Agosto,Honduras,373,546,919
2016,Agosto,Portugal,302,542,844
2016,Agosto,Bélgica,291,487,778
2016,Agosto,Japón,228,495,723
2016,Agosto,Cuba,243,452,695
2016,Agosto,República de Corea,204,474,678
2016,Agosto,India,88,533,621
2016,Agosto,Paraguay,302,319,621
2016,Agosto,Austria,199,310,509
2016,Agosto,Turquía,150,291,441
2016,Agosto,República de Irlanda,188,238,426
2016,Agosto,Suecia,158,250,408
2016,Agosto,Federación de Rusia,164,227,391
2016,Agosto,Polonia,139,206,345
2016,Agosto,Filipinas,53,261,314
2016,Agosto,Nicaragua,147,163,310
2016,Agosto,Nueva Zelanda,107,176,283
2016,Agosto,Dinamarca,84,172,256
2016,Agosto,Noruega,76,147,223
2016,Agosto,Trinidad y Tobago,50,91,141
2016,Agosto,Taiwán,50,83,133
2016,Agosto,Sudáfrica,43,85,128
2016,Agosto,Grecia,46,81,127
2016,Agosto,Finlandia,44,68,112
2016,Agosto,Rumania,42,67,109
2016,Agosto,Jamaica,33,73,106
2016,Agosto,República Checa,41,53,94
2016,Agosto,Barbados,53,37,90
2016,Agosto,Surinam,41,42,83
2016,Agosto,Hungría,38,42,80
2016,Agosto,Croacia,10,56,66
2016,Agosto,Ucrania,25,41,66
2016,Agosto,Líbano,33,31,64
2016,Agosto,Lituania,22,28,50
2016,Agosto,Singapur,19,26,45
2016,Agosto,Marruecos,17,26,43
2016,Agosto,Bulgaria,17,25,42
2016,Agosto,Eslovaquia,21,21,42
2016,Agosto,Indonesia,13,25,38
2016,Agosto,Luxemburgo,14,23,37
2016,Agosto,Egipto,13,23,36
2016,Agosto,Bahamas,10,24,34
2016,Agosto,Haití,8,24,32
2016,Agosto,Malasia,12,20,32
2016,Agosto,Islas Caimán/Territorio Británico de Ultramar,16,15,31
2016,Agosto,Serbia,17,13,30
2016,Agosto,Belice,12,15,27
2016,Agosto,Guyana,11,16,27
2016,Agosto,Tailandia,14,13,27
2016,Agosto,Eslovenia,15,11,26
2016,Agosto,Irán,6,20,26
2016,Agosto,Nigeria,4,19,23
2016,Agosto,Estonia,9,12,21
2016,Agosto,Kenia,11,10,21
2016,Agosto,Letonia,5,15,20
2016,Agosto,Emiratos Árabes,2,14,16
2016,Agosto,Arabia Saudita,2,13,15
2016,Agosto,Malta,6,9,15
2016,Agosto,Hong Kong,4,9,13
2016,Agosto,Pakistán,5,8,13
2016,Agosto,República de Belarús,6,6,12
2016,Agosto,Sri Lanka,4,8,12
2016,Agosto,Andorra,3,8,11
2016,Agosto,Argelia,2,9,11
2016,Agosto,Chipre,1,10,11
2016,Agosto,Jordania,2,8,10
2016,Agosto,Albania,3,6,9
2016,Agosto,Kazajistán,5,4,9
2016,Agosto,Santa Lucia,2,7,9
2016,Agosto,Antigua y Barbuda,0,8,8
2016,Agosto,Etiopia,1,7,8
2016,Agosto,Kuwait,0,8,8
2016,Agosto,Georgia,4,3,7
2016,Agosto,Islandia,4,3,7
2016,Agosto,Senegal,6,1,7
2016,Agosto,República Del Congo,1,5,6
2016,Agosto,Nepal,0,6,6
2016,Agosto,Palestina,3,3,6
2016,Agosto,Túnez,3,3,6
2016,Agosto,República Democrática del Congo,0,5,5
2016,Agosto,Dominica,0,5,5
2016,Agosto,Mozambique,2,3,5
2016,Agosto,República CentroÁfricana,5,0,5
2016,Agosto,San  Vicente y las Granadinas,2,3,5
2016,Agosto,Azerbaiyán,1,3,4
2016,Agosto,Bangladesh,1,3,4
2016,Agosto,Bosnia y Herzegovina,2,2,4
2016,Agosto,Camerún,0,4,4
2016,Agosto,Ghana,0,4,4
2016,Agosto,Granada,1,3,4
2016,Agosto,República de Moldavia,3,1,4
2016,Agosto,Myanmar,0,4,4
2016,Agosto,Qatar,0,4,4
2016,Agosto,Angola,1,2,3
2016,Agosto,República de Armenia,2,1,3
2016,Agosto,Burkina Faso,0,3,3
2016,Agosto,Islas Fiji,3,0,3
2016,Agosto,Guinea Ecuatorial,2,1,3
2016,Agosto,Lesoto,2,1,3
2016,Agosto,Macedonia,1,2,3
2016,Agosto,Mauricio,0,3,3
2016,Agosto,San Cristóbal y Nevis,0,3,3
2016,Agosto,Santa Sede/Ciudad del Vaticano,0,3,3
2016,Agosto,República Árabe Siria,1,2,3
2016,Agosto,Camboya,1,1,2
2016,Agosto,Iraq,0,2,2
2016,Agosto,Islas Salomón,0,2,2
2016,Agosto,República de Kosovo,1,1,2
2016,Agosto,Liberia,2,0,2
2016,Agosto,Liechtenstein,1,1,2
2016,Agosto,Sudán,0,2,2
2016,Agosto,Togo,1,1,2
2016,Agosto,Vietnam,1,1,2
2016,Agosto,Zambia,0,2,2
2016,Agosto,Zimbabue,1,1,2
2016,Agosto,Bahréin,1,0,1
2016,Agosto,Benín,0,1,1
2016,Agosto,Bermudas/Territorio Británico de Ultramar,0,1,1
2016,Agosto,Chad,0,1,1
2016,Agosto,Eritrea,0,1,1
2016,Agosto,Gambia,0,1,1
2016,Agosto,Guinea,0,1,1
2016,Agosto,Islas Christmas,0,1,1
2016,Agosto,Madagascar,1,0,1
2016,Agosto,Mónaco,0,1,1
2016,Agosto,Mongolia,0,1,1
2016,Agosto,Montenegro,0,1,1
2016,Agosto,Níger,1,0,1
2016,Agosto,Omán,0,1,1
2016,Agosto,Samoa Estadounidense/Territorio no incorporado de Estados Unidos,0,1,1
2016,Agosto,Samoa Occidental,1,0,1
2016,Agosto,San Marino,0,1,1
2016,Agosto,Suazilandia,0,1,1
2016,Agosto,República de Tayikistán,0,1,1
2016,Agosto,Tanzania,0,1,1
2016,Agosto,Turkmenistán,1,0,1
2016,Agosto,Uganda,0,1,1
2016,Agosto,Uzbekistán,0,1,1
2016,Agosto,Vanuatu,1,0,1
2016,Agosto,Anguila/Territorio Británico de Ultramar,0,1,1
2016,Agosto,S/E,74,149,223
2016,Septiembre,Venezuela,25075,29242,54317
2016,Septiembre,Estados Unidos de América,11036,21903,32939
2016,Septiembre,México,5734,9948,15682
2016,Septiembre,Brasil,7193,7773,14966
2016,Septiembre,Ecuador,5488,7836,13324
2016,Septiembre,Perú,5207,6498,11705
2016,Septiembre,Chile,4726,5692,10418
2016,Septiembre,Argentina,4230,5889,10119
2016,Septiembre,España,3026,6726,9752
2016,Septiembre,Panamá,4691,4373,9064
2016,Septiembre,Alemania,1810,2802,4612
2016,Septiembre,Francia,1316,2335,3651
2016,Septiembre,Países Bajos,1450,2138,3588
2016,Septiembre,Reino Unido de Gran Bretaña e Irlanda del Norte,1040,2166,3206
2016,Septiembre,Costa Rica,1331,1771,3102
2016,Septiembre,Italia,720,2198,2918
2016,Septiembre,Canadá,851,1622,2473
2016,Septiembre,El Salvador,1019,1281,2300
2016,Septiembre,Guatemala,810,1389,2199
2016,Septiembre,Bolivia,860,951,1811
2016,Septiembre,República Dominicana,769,1040,1809
2016,Septiembre,China,393,1026,1419
2016,Septiembre,Australia,454,708,1162
2016,Septiembre,Uruguay,465,639,1104
2016,Septiembre,Suiza,374,700,1074
2016,Septiembre,Cuba,250,737,987
2016,Septiembre,Honduras,444,534,978
2016,Septiembre,Paraguay,417,503,920
2016,Septiembre,Japón,213,644,857
2016,Septiembre,Israel,160,630,790
2016,Septiembre,Bélgica,255,516,771
2016,Septiembre,Portugal,223,547,770
2016,Septiembre,República de Corea,170,504,674
2016,Septiembre,Turquía,214,391,605
2016,Septiembre,India,77,526,603
2016,Septiembre,Federación de Rusia,207,241,448
2016,Septiembre,Suecia,161,267,428
2016,Septiembre,República de Irlanda,147,264,411
2016,Septiembre,Austria,131,262,393
2016,Septiembre,Nicaragua,143,175,318
2016,Septiembre,Polonia,119,186,305
2016,Septiembre,Dinamarca,98,203,301
2016,Septiembre,Filipinas,46,236,282
2016,Septiembre,Noruega,102,176,278
2016,Septiembre,Nueva Zelanda,95,141,236
2016,Septiembre,Taiwán,67,118,185
2016,Septiembre,Sudáfrica,51,101,152
2016,Septiembre,República Checa,45,98,143
2016,Septiembre,Rumania,66,75,141
2016,Septiembre,Grecia,26,94,120
2016,Septiembre,Finlandia,45,57,102
2016,Septiembre,Hungría,30,60,90
2016,Septiembre,Jamaica,31,55,86
2016,Septiembre,Tailandia,29,56,85
2016,Septiembre,Trinidad y Tobago,25,59,84
2016,Septiembre,Ucrania,23,58,81
2016,Septiembre,Irán,10,65,75
2016,Septiembre,Lituania,34,40,74
2016,Septiembre,Malasia,18,50,68
2016,Septiembre,Surinam,35,26,61
2016,Septiembre,Marruecos,9,48,57
2016,Septiembre,Bulgaria,25,31,56
2016,Septiembre,Egipto,7,48,55
2016,Septiembre,Líbano,20,35,55
2016,Septiembre,Eslovaquia,18,34,52
2016,Septiembre,Croacia,10,34,44
2016,Septiembre,Eslovenia,16,27,43
2016,Septiembre,Bahamas,14,27,41
2016,Septiembre,Indonesia,13,27,40
2016,Septiembre,Singapur,13,27,40
2016,Septiembre,Vietnam,9,31,40
2016,Septiembre,Kazajistán,4,33,37
2016,Septiembre,Guyana,15,17,32
2016,Septiembre,Azerbaiyán,2,28,30
2016,Septiembre,Hong Kong,13,17,30
2016,Septiembre,Haití,9,18,27
2016,Septiembre,Uzbekistán,0,27,27
2016,Septiembre,Belice,11,14,25
2016,Septiembre,Barbados,9,15,24
2016,Septiembre,Mozambique,3,21,24
2016,Septiembre,Angola,18,3,21
2016,Septiembre,Estonia,10,11,21
2016,Septiembre,Islandia,10,11,21
2016,Septiembre,Kenia,9,12,21
2016,Septiembre,Islas Salomón,0,20,20
2016,Septiembre,Malta,7,12,19
2016,Septiembre,Letonia,7,10,17
2016,Septiembre,Serbia,10,7,17
2016,Septiembre,Luxemburgo,7,9,16
2016,Septiembre,Pakistán,2,13,15
2016,Septiembre,Rwanda,0,14,14
2016,Septiembre,República de Belarús,7,6,13
2016,Septiembre,Nigeria,2,11,13
2016,Septiembre,Andorra,2,10,12
2016,Septiembre,Islas Caimán/Territorio Británico de Ultramar,5,7,12
2016,Septiembre,Georgia,0,12,12
2016,Septiembre,Palestina,8,4,12
2016,Septiembre,Emiratos Árabes,2,9,11
2016,Septiembre,San  Vicente y las Granadinas,2,9,11
2016,Septiembre,Jordania,4,6,10
2016,Septiembre,San Cristóbal y Nevis,6,4,10
2016,Septiembre,Dominica,2,7,9
2016,Septiembre,Ghana,2,7,9
2016,Septiembre,Chipre,4,4,8
2016,Septiembre,Santa Lucia,3,5,8
2016,Septiembre,Senegal,1,6,7
2016,Septiembre,Albania,3,3,6
2016,Septiembre,Antigua y Barbuda,2,4,6
2016,Septiembre,Arabia Saudita,0,6,6
2016,Septiembre,Argelia,2,4,6
2016,Septiembre,Bahréin,5,1,6
2016,Septiembre,República Árabe Siria,0,6,6
2016,Septiembre,Bangladesh,1,4,5
2016,Septiembre,Bermudas/Territorio Británico de Ultramar,2,3,5
2016,Septiembre,República Democrática del Congo,2,3,5
2016,Septiembre,Granada,2,3,5
2016,Septiembre,Mauricio,1,4,5
2016,Septiembre,Sri Lanka,1,4,5
2016,Septiembre,Túnez,3,2,5
2016,Septiembre,Bosnia y Herzegovina,0,4,4
2016,Septiembre,Liechtenstein,2,2,4
2016,Septiembre,Macedonia,1,3,4
2016,Septiembre,Zimbabue,0,4,4
2016,Septiembre,Burkina Faso,0,3,3
2016,Septiembre,Costa de Marfil,0,3,3
2016,Septiembre,Kuwait,1,2,3
2016,Septiembre,República de Kosovo,1,2,3
2016,Septiembre,República Democrática Popular  Lao,1,2,3
2016,Septiembre,Santa Sede/Ciudad del Vaticano,0,3,3
2016,Septiembre,Sudán,0,3,3
2016,Septiembre,Tanzania,2,1,3
2016,Septiembre,Benín,1,1,2
2016,Septiembre,Camerún,1,1,2
2016,Septiembre,República de Yibuti,0,2,2
2016,Septiembre,Etiopia,0,2,2
2016,Septiembre,Islas Fiji,0,2,2
2016,Septiembre,Guinea Bissau,2,0,2
2016,Septiembre,Iraq,0,2,2
2016,Septiembre,Kirguistán,0,2,2
2016,Septiembre,República de Moldavia,2,0,2
2016,Septiembre,Montenegro,0,2,2
2016,Septiembre,Myanmar,1,1,2
2016,Septiembre,República Democrática Popular de Corea,2,0,2
2016,Septiembre,Islas Vírgenes Británicas/Territorio Británico de Ultramar,1,1,2
2016,Septiembre,República Árabe de Yemen,0,2,2
2016,Septiembre,Anguila/Territorio Británico de Ultramar,1,1,2
2016,Septiembre,República de Armenia,1,0,1
2016,Septiembre,Botsuana,0,1,1
2016,Septiembre,Bután,0,1,1
2016,Septiembre,República Del Congo,0,1,1
2016,Septiembre,Guinea Ecuatorial,0,1,1
2016,Septiembre,Libia,0,1,1
2016,Septiembre,Madagascar,0,1,1
2016,Septiembre,Malí,0,1,1
2016,Septiembre,Namibia,0,1,1
2016,Septiembre,Nepal,0,1,1
2016,Septiembre,Omán,0,1,1
2016,Septiembre,Qatar,0,1,1
2016,Septiembre,Samoa Estadounidense/Territorio no incorporado de Estados Unidos,0,1,1
2016,Septiembre,San Marino,0,1,1
2016,Septiembre,Togo,0,1,1
2016,Septiembre,Zambia,0,1,1
2016,Septiembre,S/E,74,159,233
